district,year,age_range,spanish_men,spanish_women,spanish_total,foreign_total,total,spanish_men_ref,spanish_women_ref,spanish_total_ref,foreign_total_ref,total_ref,spanish_men_ratio,spanish_women_ratio,spanish_total_ratio,foreign_total_ratio,total_ratio
Arganzuela,2004,0-24,8575,8250,16825,5114,21939,8575,8250,16825,5114,21939,1.0,1.0,1.0,1.0,1.0
Arganzuela,2005,0-24,8341,7999,16340,4993,21333,8575,8250,16825,5114,21939,0.9727113702623906,0.9695757575757575,0.9711738484398217,0.9763394603050449,0.972377957062765
Arganzuela,2006,0-24,8195,7785,15980,5049,21029,8575,8250,16825,5114,21939,0.9556851311953353,0.9436363636363636,0.9497771173848439,0.9872897927258506,0.958521354665208
Arganzuela,2007,0-24,7948,7688,15636,4156,19792,8575,8250,16825,5114,21939,0.9268804664723032,0.9318787878787879,0.929331352154532,0.8126710989440751,0.9021377455672547
Arganzuela,2008,0-24,8011,7737,15748,4574,20322,8575,8250,16825,5114,21939,0.9342274052478134,0.9378181818181818,0.9359881129271916,0.8944075087993743,0.9262956379051005
Arganzuela,2009,0-24,7928,7698,15626,4389,20015,8575,8250,16825,5114,21939,0.9245481049562683,0.9330909090909091,0.928736998514116,0.8582323034806414,0.9123022927207256
Arganzuela,2010,0-24,7896,7659,15555,3944,19499,8575,8250,16825,5114,21939,0.9208163265306123,0.9283636363636364,0.924517087667162,0.7712162690653109,0.8887825333880305
Arganzuela,2011,0-24,7947,7667,15614,3516,19130,8575,8250,16825,5114,21939,0.9267638483965015,0.9293333333333333,0.9280237741456167,0.6875244427062964,0.871963170609417
Arganzuela,2012,0-24,8095,7731,15826,2960,18786,8575,8250,16825,5114,21939,0.9440233236151604,0.9370909090909091,0.9406240713224369,0.5788032850997262,0.8562833310542869
Arganzuela,2013,0-24,8134,7843,15977,2701,18678,8575,8250,16825,5114,21939,0.9485714285714286,0.9506666666666667,0.9495988112927192,0.5281579976535002,0.8513605907288391
Arganzuela,2014,0-24,8134,7834,15968,2270,18238,8575,8250,16825,5114,21939,0.9485714285714286,0.9495757575757576,0.9490638930163448,0.4438795463433711,0.831304981995533
Arganzuela,2015,0-24,8219,7896,16115,1945,18060,8575,8250,16825,5114,21939,0.9584839650145772,0.9570909090909091,0.9578008915304607,0.3803285099726242,0.823191576644332
Arganzuela,2016,0-24,8348,8020,16368,1921,18289,8575,8250,16825,5114,21939,0.9735276967930029,0.9721212121212122,0.9728380386329867,0.37563551036370746,0.833629609371439
Arganzuela,2017,0-24,8363,8065,16428,1783,18211,8575,8250,16825,5114,21939,0.9752769679300292,0.9775757575757575,0.976404160475483,0.34865076261243644,0.8300742969141711
Arganzuela,2004,25-39,14493,15016,29509,10750,40259,14493,15016,29509,10750,40259,1.0,1.0,1.0,1.0,1.0
Arganzuela,2005,25-39,14256,14730,28986,11626,40612,14493,15016,29509,10750,40259,0.983647277996274,0.9809536494405967,0.9822765935816191,1.0814883720930233,1.0087682257383441
Arganzuela,2006,25-39,13993,14444,28437,12467,40904,14493,15016,29509,10750,40259,0.9655005864900297,0.9619072988811934,0.9636721000372768,1.1597209302325582,1.0160212623264364
Arganzuela,2007,25-39,14135,14487,28622,11182,39804,14493,15016,29509,10750,40259,0.9752984199268613,0.9647709110282365,0.9699413738181571,1.040186046511628,0.9886981792891031
Arganzuela,2008,25-39,14672,14971,29643,11959,41602,14493,15016,29509,10750,40259,1.0123507900365694,0.9970031965903037,1.0045409874953404,1.1124651162790697,1.0333590004719442
Arganzuela,2009,25-39,14638,14938,29576,12316,41892,14493,15016,29509,10750,40259,1.0100048299178914,0.9948055407565264,1.0022704937476703,1.1456744186046512,1.040562358727241
Arganzuela,2010,25-39,14699,15044,29743,11951,41694,14493,15016,29509,10750,40259,1.0142137583661077,1.0018646776771445,1.007929784133654,1.1117209302325581,1.0356442037805211
Arganzuela,2011,25-39,14724,15091,29815,11510,41325,14493,15016,29509,10750,40259,1.0159387290416062,1.0049946723494938,1.01036971771324,1.0706976744186048,1.0264785513798156
Arganzuela,2012,25-39,14631,15089,29720,10233,39953,14493,15016,29509,10750,40259,1.0095218381287518,1.0048614810868408,1.007150360906842,0.951906976744186,0.9923992150823419
Arganzuela,2013,25-39,14817,15076,29893,9438,39331,14493,15016,29509,10750,40259,1.0223556199544608,1.0039957378795952,1.0130129790911246,0.877953488372093,0.9769492535830497
Arganzuela,2014,25-39,14424,14859,29283,7954,37237,14493,15016,29509,10750,40259,0.9952390809356241,0.9895444858817262,0.992341319597411,0.739906976744186,0.9249360391465262
Arganzuela,2015,25-39,14099,14647,28746,6790,35536,14493,15016,29509,10750,40259,0.9728144621541434,0.9754262120404902,0.9741434816496662,0.6316279069767442,0.88268461710425
Arganzuela,2016,25-39,14189,14655,28844,6676,35520,14493,15016,29509,10750,40259,0.979024356585938,0.9759589770911028,0.9774645023552136,0.6210232558139535,0.8822871904418887
Arganzuela,2017,25-39,14144,14498,28642,6470,35112,14493,15016,29509,10750,40259,0.9759194093700407,0.965503462972829,0.9706191331458199,0.6018604651162791,0.8721528105516779
Arganzuela,2004,40-64,19195,22860,42055,4818,46873,19195,22860,42055,4818,46873,1.0,1.0,1.0,1.0,1.0
Arganzuela,2005,40-64,19849,23559,43408,5472,48880,19195,22860,42055,4818,46873,1.0340713727533213,1.0305774278215223,1.032172155510641,1.1357409713574098,1.0428178268939474
Arganzuela,2006,40-64,20232,23879,44111,6269,50380,19195,22860,42055,4818,46873,1.0540244855431102,1.0445756780402449,1.0488883604803234,1.301162308011623,1.0748191922855375
Arganzuela,2007,40-64,21286,24778,46064,5892,51956,19195,22860,42055,4818,46873,1.1089346183902058,1.083902012248469,1.0953275472595412,1.2229140722291407,1.1084419601903015
Arganzuela,2008,40-64,21699,25202,46901,5934,52835,19195,22860,42055,4818,46873,1.1304506381870278,1.1024496937882764,1.1152300558792059,1.2316313823163139,1.1271947603097732
Arganzuela,2009,40-64,22255,25696,47951,6294,54245,19195,22860,42055,4818,46873,1.1594165147173743,1.1240594925634295,1.1401973605992153,1.3063511830635117,1.1572760437778677
Arganzuela,2010,40-64,22695,26189,48884,6312,55196,19195,22860,42055,4818,46873,1.182339150820526,1.1456255468066492,1.1623825942218524,1.3100871731008716,1.177564909436136
Arganzuela,2011,40-64,23113,26534,49647,6314,55961,19195,22860,42055,4818,46873,1.2041156551185204,1.1607174103237095,1.1805255023183925,1.3105022831050228,1.193885605785847
Arganzuela,2012,40-64,23543,27023,50566,5771,56337,19195,22860,42055,4818,46873,1.226517322219328,1.182108486439195,1.2023778385447628,1.1977999169779991,1.2019072813773388
Arganzuela,2013,40-64,23921,27486,51407,5489,56896,19195,22860,42055,4818,46873,1.2462099505079447,1.2023622047244094,1.222375460706218,1.139269406392694,1.2138331235466047
Arganzuela,2014,40-64,24117,27561,51678,4952,56630,19195,22860,42055,4818,46873,1.2564209429538942,1.2056430446194226,1.2288194031625252,1.0278123702781237,1.2081582147504961
Arganzuela,2015,40-64,24256,27887,52143,4466,56609,19195,22860,42055,4818,46873,1.2636624120864808,1.2199037620297464,1.2398763523956724,0.9269406392694064,1.2077101956350138
Arganzuela,2016,40-64,24449,28173,52622,4577,57199,19195,22860,42055,4818,46873,1.273717113831727,1.2324146981627297,1.2512661990250862,0.9499792444997924,1.2202973993557058
Arganzuela,2017,40-64,24699,28265,52964,4619,57583,19195,22860,42055,4818,46873,1.286741338890336,1.2364391951006124,1.259398406848175,0.9586965545869656,1.228489748895953
Arganzuela,2004,65-84,8075,13407,21482,408,21890,8075,13407,21482,408,21890,1.0,1.0,1.0,1.0,1.0
Arganzuela,2005,65-84,7924,13153,21077,480,21557,8075,13407,21482,408,21890,0.9813003095975232,0.9810546729320504,0.9811470067963877,1.1764705882352942,0.9847875742348104
Arganzuela,2006,65-84,8026,13153,21179,542,21721,8075,13407,21482,408,21890,0.9939318885448917,0.9810546729320504,0.9858951680476679,1.3284313725490196,0.9922795797167656
Arganzuela,2007,65-84,8096,12956,21052,398,21450,8075,13407,21482,408,21890,1.0026006191950465,0.9663608562691132,0.979983241783819,0.9754901960784313,0.9798994974874372
Arganzuela,2008,65-84,8085,12866,20951,367,21318,8075,13407,21482,408,21890,1.0012383900928792,0.9596479451033042,0.9752816311330417,0.8995098039215687,0.9738693467336683
Arganzuela,2009,65-84,8133,12779,20912,390,21302,8075,13407,21482,408,21890,1.0071826625386997,0.9531587976430222,0.9734661577134345,0.9558823529411765,0.9731384193695751
Arganzuela,2010,65-84,8138,12755,20893,428,21321,8075,13407,21482,408,21890,1.0078018575851393,0.9513686879988066,0.9725816963038824,1.0490196078431373,0.9740063956144358
Arganzuela,2011,65-84,8221,12819,21040,449,21489,8075,13407,21482,408,21890,1.0180804953560372,0.9561423137167151,0.9794246345777861,1.1004901960784315,0.9816811329374143
Arganzuela,2012,65-84,8314,12794,21108,393,21501,8075,13407,21482,408,21890,1.0295975232198142,0.9542776161706571,0.9825900754119729,0.9632352941176471,0.9822293284604843
Arganzuela,2013,65-84,8482,12864,21346,400,21746,8075,13407,21482,408,21890,1.0504024767801858,0.9594987692996196,0.9936691183316265,0.9803921568627451,0.9934216537231613
Arganzuela,2014,65-84,8658,13016,21674,374,22048,8075,13407,21482,408,21890,1.0721981424148608,0.9708361303796524,1.0089377152965273,0.9166666666666666,1.0072179077204202
Arganzuela,2015,65-84,8789,13103,21892,371,22263,8075,13407,21482,408,21890,1.088421052631579,0.9773252778399344,1.019085746206126,0.9093137254901961,1.0170397441754226
Arganzuela,2016,65-84,8972,13253,22225,388,22613,8075,13407,21482,408,21890,1.1110835913312693,0.9885134631162825,1.0345870961735406,0.9509803921568627,1.0330287802649611
Arganzuela,2017,65-84,9182,13457,22639,425,23064,8075,13407,21482,408,21890,1.1370897832817337,1.003729395092116,1.0538590447816776,1.0416666666666667,1.053631795340338
Arganzuela,2004,85-100,981,2716,3697,23,3720,981,2716,3697,23,3720,1.0,1.0,1.0,1.0,1.0
Arganzuela,2005,85-100,981,2777,3758,26,3784,981,2716,3697,23,3720,1.0,1.022459499263623,1.0164998647552068,1.1304347826086956,1.0172043010752687
Arganzuela,2006,85-100,981,2903,3884,29,3913,981,2716,3697,23,3720,1.0,1.0688512518409425,1.0505815526102245,1.2608695652173914,1.0518817204301076
Arganzuela,2007,85-100,1089,3144,4233,20,4253,981,2716,3697,23,3720,1.110091743119266,1.1575846833578793,1.1449824181769002,0.8695652173913043,1.1432795698924731
Arganzuela,2008,85-100,1075,3150,4225,24,4249,981,2716,3697,23,3720,1.0958205912334353,1.1597938144329898,1.1428185014876928,1.0434782608695652,1.1422043010752687
Arganzuela,2009,85-100,1124,3208,4332,33,4365,981,2716,3697,23,3720,1.145769622833843,1.1811487481590575,1.1717608872058425,1.434782608695652,1.1733870967741935
Arganzuela,2010,85-100,1187,3290,4477,35,4512,981,2716,3697,23,3720,1.2099898063200816,1.211340206185567,1.2109818771977279,1.5217391304347827,1.2129032258064516
Arganzuela,2011,85-100,1239,3434,4673,44,4717,981,2716,3697,23,3720,1.2629969418960245,1.264359351988218,1.2639978360833108,1.9130434782608696,1.268010752688172
Arganzuela,2012,85-100,1302,3524,4826,43,4869,981,2716,3697,23,3720,1.327217125382263,1.2974963181148749,1.3053827427644036,1.8695652173913044,1.3088709677419355
Arganzuela,2013,85-100,1315,3581,4896,45,4941,981,2716,3697,23,3720,1.3404689092762487,1.3184830633284241,1.324317013794969,1.9565217391304348,1.3282258064516128
Arganzuela,2014,85-100,1391,3744,5135,40,5175,981,2716,3697,23,3720,1.417940876656473,1.3784977908689249,1.388964024885042,1.7391304347826086,1.3911290322580645
Arganzuela,2015,85-100,1505,3861,5366,31,5397,981,2716,3697,23,3720,1.5341488277268094,1.4215758468335788,1.4514471192859075,1.3478260869565217,1.4508064516129033
Arganzuela,2016,85-100,1544,3932,5476,31,5507,981,2716,3697,23,3720,1.5739041794087665,1.4477172312223858,1.4812009737625103,1.3478260869565217,1.4803763440860216
Arganzuela,2017,85-100,1601,3973,5574,35,5609,981,2716,3697,23,3720,1.6320081549439347,1.4628129602356406,1.5077089532053016,1.5217391304347827,1.5077956989247312
Arganzuela,2004,Total,56607,67140,123747,23420,147167,56607,67140,123747,23420,147167,1.0,1.0,1.0,1.0,1.0
Arganzuela,2005,Total,56755,67249,124004,24809,148813,56607,67140,123747,23420,147167,1.0026145176391612,1.001623473339291,1.0020768180238713,1.0593082835183605,1.0111845726283746
Arganzuela,2006,Total,56976,67362,124338,26442,150780,56607,67140,123747,23420,147167,1.006518628438179,1.0033065236818588,1.0047758733545056,1.1290350128095645,1.0245503407693302
Arganzuela,2007,Total,58065,68222,126287,23212,149499,56607,67140,123747,23420,147167,1.025756531877683,1.0161155793863568,1.0205257501191949,0.9911187019641332,1.0158459437237968
Arganzuela,2008,Total,59271,69398,128669,24549,153218,56607,67140,123747,23420,147167,1.0470613175049022,1.033631218349717,1.0397747016089278,1.048206660973527,1.0411165546623904
Arganzuela,2009,Total,59929,69988,129917,25129,155046,56607,67140,123747,23420,147167,1.0586853216033352,1.0424188263330354,1.0498597945808787,1.0729718189581554,1.0535378175813872
Arganzuela,2010,Total,60525,70690,131215,24215,155430,56607,67140,123747,23420,147167,1.0692140547988764,1.0528745904081025,1.0603489377520263,1.0339453458582408,1.056147098194568
Arganzuela,2011,Total,61149,71378,132527,23271,155798,56607,67140,123747,23420,147167,1.0802374264666914,1.0631218349717009,1.070951214978949,0.9936379163108454,1.0586476587821998
Arganzuela,2012,Total,61697,72003,133700,20731,154431,56607,67140,123747,23420,147167,1.0899182079954777,1.0724307417336907,1.0804302326521047,0.8851836037574723,1.0493588915993395
Arganzuela,2013,Total,62542,72713,135255,19411,154666,56607,67140,123747,23420,147167,1.1048456904623103,1.0830056598153113,1.0929961938471235,0.8288215200683177,1.0509557169745936
Arganzuela,2014,Total,62512,72757,135269,16783,152052,56607,67140,123747,23420,147167,1.1043157206705885,1.0836610068513555,1.0931093279028987,0.7166097352690008,1.033193582800492
Arganzuela,2015,Total,62674,73146,135820,14647,150467,56607,67140,123747,23420,147167,1.1071775575458866,1.0894548704200178,1.0975619610980467,0.6254056362083689,1.0224235052695236
Arganzuela,2016,Total,63419,73846,137265,14636,151901,56607,67140,123747,23420,147167,1.120338474040313,1.0998808459934466,1.1092390118548328,0.624935952177626,1.0321675375593713
Arganzuela,2017,Total,63950,74072,138022,14315,152337,56607,67140,123747,23420,147167,1.12971893935379,1.1032469466785821,1.1153563318706716,0.6112297181895816,1.0351301582555872
Barajas,2004,0-24,3264,3037,6301,859,7160,3264,3037,6301,859,7160,1.0,1.0,1.0,1.0,1.0
Barajas,2005,0-24,3081,2847,5928,898,6826,3264,3037,6301,859,7160,0.9439338235294118,0.9374382614422128,0.9408030471353753,1.0454016298020954,0.9533519553072626
Barajas,2006,0-24,2978,2728,5706,1009,6715,3264,3037,6301,859,7160,0.9123774509803921,0.8982548567665459,0.9055705443580384,1.1746216530849825,0.9378491620111732
Barajas,2007,0-24,2842,2620,5462,878,6340,3264,3037,6301,859,7160,0.8707107843137255,0.8626934474810668,0.8668465322964609,1.0221187427240979,0.8854748603351955
Barajas,2008,0-24,2793,2569,5362,1014,6376,3264,3037,6301,859,7160,0.8556985294117647,0.8459005597629239,0.8509760355499127,1.180442374854482,0.8905027932960894
Barajas,2009,0-24,2784,2574,5358,1051,6409,3264,3037,6301,859,7160,0.8529411764705882,0.8475469213039183,0.8503412156800508,1.2235157159487777,0.8951117318435754
Barajas,2010,0-24,2722,2579,5301,1052,6353,3264,3037,6301,859,7160,0.8339460784313726,0.8491932828449127,0.8412950325345183,1.2246798603026776,0.8872905027932961
Barajas,2011,0-24,2746,2643,5389,1003,6392,3264,3037,6301,859,7160,0.8412990196078431,0.8702667105696411,0.8552610696714807,1.1676367869615831,0.8927374301675978
Barajas,2012,0-24,2795,2668,5463,847,6310,3264,3037,6301,859,7160,0.8563112745098039,0.8784985182746131,0.8670052372639263,0.9860302677532014,0.8812849162011173
Barajas,2013,0-24,2848,2693,5541,769,6310,3264,3037,6301,859,7160,0.8725490196078431,0.8867303259795851,0.8793842247262339,0.8952270081490105,0.8812849162011173
Barajas,2014,0-24,2947,2757,5704,632,6336,3264,3037,6301,859,7160,0.9028799019607843,0.9078037537043134,0.9052531344231074,0.7357392316647264,0.8849162011173184
Barajas,2015,0-24,3060,2785,5845,558,6403,3264,3037,6301,859,7160,0.9375,0.9170233783338821,0.9276305348357403,0.6495925494761351,0.8942737430167598
Barajas,2016,0-24,3191,2897,6088,540,6628,3264,3037,6301,859,7160,0.9776348039215687,0.9539018768521568,0.9661958419298524,0.6286379511059371,0.9256983240223464
Barajas,2017,0-24,3233,3013,6246,572,6818,3264,3037,6301,859,7160,0.9905024509803921,0.9920974646032269,0.9912712267893985,0.6658905704307334,0.9522346368715083
Barajas,2004,25-39,5402,5268,10670,1652,12322,5402,5268,10670,1652,12322,1.0,1.0,1.0,1.0,1.0
Barajas,2005,25-39,5392,5272,10664,1886,12550,5402,5268,10670,1652,12322,0.9981488337652721,1.0007593014426728,0.9994376757263356,1.1416464891041163,1.0185034896932317
Barajas,2006,25-39,5373,5204,10577,2233,12810,5402,5268,10670,1652,12322,0.9946316179192891,0.9878511769172361,0.9912839737582005,1.3516949152542372,1.0396039603960396
Barajas,2007,25-39,5172,4957,10129,2252,12381,5402,5268,10670,1652,12322,0.9574231766012588,0.9409643128321944,0.9492970946579194,1.3631961259079903,1.0047881837364063
Barajas,2008,25-39,5013,4870,9883,2443,12326,5402,5268,10670,1652,12322,0.9279896334690855,0.9244495064540622,0.9262417994376757,1.478813559322034,1.000324622626197
Barajas,2009,25-39,4948,4846,9794,2617,12411,5402,5268,10670,1652,12322,0.9159570529433543,0.9198936977980258,0.9179006560449859,1.584140435835351,1.0072228534328842
Barajas,2010,25-39,4909,4828,9737,2714,12451,5402,5268,10670,1652,12322,0.9087375046279156,0.9164768413059985,0.9125585754451734,1.6428571428571428,1.0104690796948548
Barajas,2011,25-39,4783,4746,9529,2635,12164,5402,5268,10670,1652,12322,0.8854128100703443,0.9009111617312073,0.8930646672914714,1.5950363196125907,0.9871774062652167
Barajas,2012,25-39,4651,4609,9260,2411,11671,5402,5268,10670,1652,12322,0.8609774157719363,0.8749050873196659,0.8678537956888472,1.4594430992736078,0.9471676675864308
Barajas,2013,25-39,4478,4421,8899,2173,11072,5402,5268,10670,1652,12322,0.828952239911144,0.8392179195140471,0.8340206185567011,1.3153753026634383,0.8985554293134231
Barajas,2014,25-39,4267,4200,8467,1872,10339,5402,5268,10670,1652,12322,0.7898926323583858,0.7972665148063781,0.7935332708528585,1.1331719128329298,0.8390683330628145
Barajas,2015,25-39,4188,4119,8307,1592,9899,5402,5268,10670,1652,12322,0.7752684191040355,0.7818906605922551,0.7785379568884724,0.9636803874092009,0.8033598441811394
Barajas,2016,25-39,4017,3976,7993,1523,9516,5402,5268,10670,1652,12322,0.7436134764901888,0.7547456340167046,0.7491096532333645,0.9219128329297821,0.7722772277227723
Barajas,2017,25-39,3909,3854,7763,1473,9236,5402,5268,10670,1652,12322,0.7236208811551277,0.731586940015186,0.7275538894095596,0.8916464891041163,0.749553643888979
Barajas,2004,40-64,6061,6525,12586,966,13552,6061,6525,12586,966,13552,1.0,1.0,1.0,1.0,1.0
Barajas,2005,40-64,6229,6720,12949,1123,14072,6061,6525,12586,966,13552,1.0277181983171093,1.0298850574712644,1.028841569998411,1.1625258799171843,1.038370720188902
Barajas,2006,40-64,6312,6848,13160,1312,14472,6061,6525,12586,966,13552,1.041412308199967,1.0495019157088123,1.0456062291434927,1.3581780538302277,1.0678866587957496
Barajas,2007,40-64,6504,7049,13553,1318,14871,6061,6525,12586,966,13552,1.0730902491338064,1.0803065134099616,1.0768313999682186,1.3643892339544514,1.0973288075560803
Barajas,2008,40-64,6475,7027,13502,1387,14889,6061,6525,12586,966,13552,1.068305560138591,1.0769348659003832,1.0727792785634833,1.4358178053830228,1.0986570247933884
Barajas,2009,40-64,6608,7179,13787,1588,15375,6061,6525,12586,966,13552,1.0902491338063025,1.1002298850574712,1.0954234864134753,1.6438923395445135,1.1345188902007084
Barajas,2010,40-64,6633,7289,13922,1737,15659,6061,6525,12586,966,13552,1.0943738656987296,1.117088122605364,1.1061496901318926,1.7981366459627328,1.1554752066115703
Barajas,2011,40-64,6824,7392,14216,1804,16020,6061,6525,12586,966,13552,1.125886817356872,1.1328735632183908,1.1295089782297791,1.8674948240165632,1.1821133412042504
Barajas,2012,40-64,6946,7525,14471,1639,16110,6061,6525,12586,966,13552,1.1460155089919155,1.1532567049808429,1.1497695852534562,1.696687370600414,1.188754427390791
Barajas,2013,40-64,7094,7686,14780,1567,16347,6061,6525,12586,966,13552,1.1704339217950832,1.1779310344827587,1.1743206737645002,1.6221532091097308,1.2062426210153483
Barajas,2014,40-64,7138,7762,14900,1411,16311,6061,6525,12586,966,13552,1.1776934499257548,1.1895785440613027,1.18385507706976,1.4606625258799173,1.203586186540732
Barajas,2015,40-64,7245,7879,15124,1321,16445,6061,6525,12586,966,13552,1.1953473024253423,1.2075095785440613,1.201652629906245,1.3674948240165632,1.213474025974026
Barajas,2016,40-64,7464,8055,15519,1386,16905,6061,6525,12586,966,13552,1.2314799538030028,1.2344827586206897,1.2330367074527253,1.434782608695652,1.2474173553719008
Barajas,2017,40-64,7632,8246,15878,1420,17298,6061,6525,12586,966,13552,1.259198152120112,1.2637547892720307,1.2615604640076274,1.4699792960662525,1.2764167650531286
Barajas,2004,65-84,1841,2071,3912,87,3999,1841,2071,3912,87,3999,1.0,1.0,1.0,1.0,1.0
Barajas,2005,65-84,1913,2120,4033,101,4134,1841,2071,3912,87,3999,1.0391091797935905,1.0236600676001932,1.0309304703476483,1.160919540229885,1.0337584396099024
Barajas,2006,65-84,2044,2252,4296,121,4417,1841,2071,3912,87,3999,1.1102661596958174,1.0873973925639788,1.098159509202454,1.3908045977011494,1.1045261315328831
Barajas,2007,65-84,2119,2397,4516,102,4618,1841,2071,3912,87,3999,1.1510048886474742,1.1574118783196523,1.1543967280163598,1.1724137931034482,1.1547886971742936
Barajas,2008,65-84,2141,2441,4582,100,4682,1841,2071,3912,87,3999,1.1629549158066268,1.178657653307581,1.1712678936605316,1.1494252873563218,1.1707926981745436
Barajas,2009,65-84,2271,2585,4856,108,4964,1841,2071,3912,87,3999,1.2335687126561652,1.2481892805408015,1.2413087934560327,1.2413793103448276,1.2413103275818955
Barajas,2010,65-84,2409,2767,5176,128,5304,1841,2071,3912,87,3999,1.3085279739272135,1.3360695316272333,1.3231083844580778,1.471264367816092,1.3263315828957238
Barajas,2011,65-84,2535,2935,5470,151,5621,1841,2071,3912,87,3999,1.3769690385659967,1.417189763399324,1.3982617586912065,1.735632183908046,1.4056014003500876
Barajas,2012,65-84,2664,3071,5735,154,5889,1841,2071,3912,87,3999,1.4470396523628464,1.4828585224529214,1.466002044989775,1.7701149425287357,1.4726181545386348
Barajas,2013,65-84,2774,3232,6006,152,6158,1841,2071,3912,87,3999,1.5067897881586094,1.5605987445678415,1.5352760736196318,1.7471264367816093,1.5398849712428107
Barajas,2014,65-84,2924,3395,6319,148,6467,1841,2071,3912,87,3999,1.588267246061923,1.6393046837276677,1.6152862985685073,1.7011494252873562,1.617154288572143
Barajas,2015,65-84,3040,3578,6618,172,6790,1841,2071,3912,87,3999,1.6512764801738187,1.7276677933365523,1.6917177914110428,1.9770114942528736,1.69792448112028
Barajas,2016,65-84,3119,3672,6791,184,6975,1841,2071,3912,87,3999,1.6941879413362304,1.773056494447127,1.7359406952965235,2.1149425287356323,1.744186046511628
Barajas,2017,65-84,3180,3817,6997,198,7195,1841,2071,3912,87,3999,1.7273221075502445,1.8430709802028005,1.78859918200409,2.2758620689655173,1.7991997999499876
Barajas,2004,85-100,111,292,403,12,415,111,292,403,12,415,1.0,1.0,1.0,1.0,1.0
Barajas,2005,85-100,114,309,423,15,438,111,292,403,12,415,1.027027027027027,1.0582191780821917,1.0496277915632755,1.25,1.0554216867469879
Barajas,2006,85-100,127,323,450,17,467,111,292,403,12,415,1.1441441441441442,1.106164383561644,1.1166253101736974,1.4166666666666667,1.1253012048192772
Barajas,2007,85-100,178,370,548,9,557,111,292,403,12,415,1.6036036036036037,1.2671232876712328,1.3598014888337469,0.75,1.342168674698795
Barajas,2008,85-100,197,406,603,8,611,111,292,403,12,415,1.7747747747747749,1.3904109589041096,1.4962779156327544,0.6666666666666666,1.472289156626506
Barajas,2009,85-100,218,433,651,8,659,111,292,403,12,415,1.9639639639639639,1.4828767123287672,1.6153846153846154,0.6666666666666666,1.5879518072289156
Barajas,2010,85-100,212,467,679,8,687,111,292,403,12,415,1.90990990990991,1.5993150684931507,1.684863523573201,0.6666666666666666,1.655421686746988
Barajas,2011,85-100,217,484,701,11,712,111,292,403,12,415,1.954954954954955,1.6575342465753424,1.739454094292804,0.9166666666666666,1.7156626506024097
Barajas,2012,85-100,236,506,742,9,751,111,292,403,12,415,2.126126126126126,1.7328767123287672,1.8411910669975187,0.75,1.8096385542168674
Barajas,2013,85-100,241,513,754,14,768,111,292,403,12,415,2.171171171171171,1.7568493150684932,1.8709677419354838,1.1666666666666667,1.8506024096385543
Barajas,2014,85-100,261,559,820,15,835,111,292,403,12,415,2.3513513513513513,1.9143835616438356,2.034739454094293,1.25,2.0120481927710845
Barajas,2015,85-100,283,579,862,13,875,111,292,403,12,415,2.5495495495495497,1.9828767123287672,2.138957816377171,1.0833333333333333,2.108433734939759
Barajas,2016,85-100,290,612,902,16,918,111,292,403,12,415,2.6126126126126126,2.095890410958904,2.238213399503722,1.3333333333333333,2.212048192771084
Barajas,2017,85-100,308,637,945,20,965,111,292,403,12,415,2.774774774774775,2.1815068493150687,2.3449131513647643,1.6666666666666667,2.325301204819277
Barajas,2004,Total,18590,18962,37552,3949,41501,18590,18962,37552,3949,41501,1.0,1.0,1.0,1.0,1.0
Barajas,2005,Total,18839,19196,38035,4439,42474,18590,18962,37552,3949,41501,1.0133942980096826,1.0123404704145131,1.0128621644652749,1.124082046087617,1.0234452181875136
Barajas,2006,Total,19136,19407,38543,5149,43692,18590,18962,37552,3949,41501,1.0293706293706293,1.0234679886087965,1.0263900724328932,1.3038743985819194,1.052793908580516
Barajas,2007,Total,19136,19549,38685,4978,43663,18590,18962,37552,3949,41501,1.0293706293706293,1.0309566501423901,1.0301714955262036,1.2605722967839958,1.0520951302378256
Barajas,2008,Total,19000,19524,38524,5437,43961,18590,18962,37552,3949,41501,1.0220548682087143,1.029638223816053,1.025884107371112,1.3768042542415801,1.059275680104094
Barajas,2009,Total,19350,19954,39304,5874,45178,18590,18962,37552,3949,41501,1.0408821947283486,1.0523151566290476,1.0466553046442266,1.4874651810584958,1.0886002746921761
Barajas,2010,Total,19492,20297,39789,6178,45967,18590,18962,37552,3949,41501,1.0485207100591716,1.0704039658263895,1.059570728589689,1.5644466953659155,1.1076118647743427
Barajas,2011,Total,19784,20643,40427,6146,46573,18590,18962,37552,3949,41501,1.064228079612695,1.0886509861828921,1.0765605027694929,1.5563433780703975,1.122213922556083
Barajas,2012,Total,19953,20824,40777,5544,46321,18590,18962,37552,3949,41501,1.073318988703604,1.0981963927855711,1.0858809118023007,1.4038997214484679,1.1161417797161515
Barajas,2013,Total,20106,20969,41075,5131,46206,18590,18962,37552,3949,41501,1.0815492200107584,1.105843265478325,1.0938165743502344,1.2993162826031908,1.1133707621503097
Barajas,2014,Total,20173,21040,41213,4508,45721,18590,18962,37552,3949,41501,1.0851533082302314,1.1095875962451218,1.09749147848317,1.1415548240060776,1.1016842967639333
Barajas,2015,Total,20462,21306,41768,4044,45812,18590,18962,37552,3949,41501,1.1006993006993007,1.1236156523573462,1.1122709842351939,1.0240567232210687,1.1038770150116866
Barajas,2016,Total,20738,21629,42367,4006,46373,18590,18962,37552,3949,41501,1.1155459924690694,1.1406497204936188,1.128222198551342,1.0144340339326412,1.1173947615720103
Barajas,2017,Total,20971,21977,42948,4052,47000,18590,18962,37552,3949,41501,1.1280796126949972,1.1590022149562282,1.143694077545803,1.0260825525449482,1.1325028312570782
Carabanchel,2004,0-24,13756,13303,27059,9617,36676,13756,13303,27059,9617,36676,1.0,1.0,1.0,1.0,1.0
Carabanchel,2005,0-24,13072,12603,25675,10344,36019,13756,13303,27059,9617,36676,0.9502762430939227,0.9473802901601143,0.9488525074836468,1.0755952999896017,0.9820863780128695
Carabanchel,2006,0-24,12507,12144,24651,11353,36004,13756,13303,27059,9617,36676,0.9092032567606863,0.9128767947079606,0.9110092760264606,1.180513673702818,0.9816773912095103
Carabanchel,2007,0-24,11896,11503,23399,11097,34496,13756,13303,27059,9617,36676,0.8647862750799651,0.8646921746974366,0.8647400125651354,1.1538941457835084,0.9405605845784709
Carabanchel,2008,0-24,11853,11457,23310,12781,36091,13756,13303,27059,9617,36676,0.8616603663855772,0.8612343080508156,0.8614509035810636,1.3290007278777165,0.9840495146689934
Carabanchel,2009,0-24,11719,11353,23072,12785,35857,13756,13303,27059,9617,36676,0.8519191625472521,0.8534165225888897,0.8526553087697254,1.3294166580014557,0.9776693205365907
Carabanchel,2010,0-24,11790,11336,23126,11972,35098,13756,13303,27059,9617,36676,0.8570805466705438,0.8521386153499211,0.8546509479286004,1.244878860351461,0.956974588286618
Carabanchel,2011,0-24,11915,11474,23389,10985,34374,13756,13303,27059,9617,36676,0.8661674905495783,0.8625122152897843,0.8643704497579363,1.1422481023188105,0.9372341585778166
Carabanchel,2012,0-24,12300,11697,23997,9306,33303,13756,13303,27059,9617,36676,0.894155277697005,0.8792753514244908,0.8868398684356407,0.9676614328792763,0.9080325008179736
Carabanchel,2013,0-24,12576,12091,24667,8080,32747,13756,13303,27059,9617,36676,0.9142192497819134,0.9088927309629407,0.9116005765179792,0.8401788499532079,0.8928727233067947
Carabanchel,2014,0-24,12802,12334,25136,7015,32151,13756,13303,27059,9617,36676,0.9306484443152079,0.9271592873787867,0.9289330721756163,0.7294374545076427,0.8766223143199913
Carabanchel,2015,0-24,13176,12777,25953,6226,32179,13756,13303,27059,9617,36676,0.9578365804012794,0.9604600466060287,0.9591263535237814,0.6473952376000832,0.8773857563529284
Carabanchel,2016,0-24,13597,13241,26838,6146,32984,13756,13303,27059,9617,36676,0.9884414073858679,0.9953393971284673,0.9918326619609003,0.639076635125299,0.8993347147998692
Carabanchel,2017,0-24,13983,13675,27658,6470,34128,13756,13303,27059,9617,36676,1.0165018900843268,1.0279636172291964,1.022136812151225,0.6727669751481751,0.9305267750027266
Carabanchel,2004,25-39,24068,23531,47599,18973,66572,24068,23531,47599,18973,66572,1.0,1.0,1.0,1.0,1.0
Carabanchel,2005,25-39,23623,23281,46904,21954,68858,24068,23531,47599,18973,66572,0.9815107196277214,0.9893757171390931,0.9853988529170781,1.1571180098034048,1.0343387610406778
Carabanchel,2006,25-39,23262,23177,46439,25113,71552,24068,23531,47599,18973,66572,0.9665115506066146,0.9849560154689558,0.9756297401205908,1.3236177726242555,1.0748062248392718
Carabanchel,2007,25-39,22571,22463,45034,25580,70614,24068,23531,47599,18973,66572,0.9378012298487618,0.9546130636182057,0.9461123132838926,1.3482316976756443,1.06071621702818
Carabanchel,2008,25-39,22420,22418,44838,27485,72323,24068,23531,47599,18973,66572,0.9315273392055842,0.9527006927032425,0.9419945797180613,1.4486375375533653,1.0863876704920987
Carabanchel,2009,25-39,21959,22041,44000,28500,72500,24068,23531,47599,18973,66572,0.9123732757187968,0.936679274148995,0.9243891678396605,1.502134612343857,1.0890464459532536
Carabanchel,2010,25-39,21188,21424,42612,27986,70598,24068,23531,47599,18973,66572,0.8803390393883995,0.9104585440482768,0.8952288913632639,1.4750434828440415,1.060475875743556
Carabanchel,2011,25-39,20302,20822,41124,26748,67872,24068,23531,47599,18973,66572,0.8435266744224696,0.8848752709192129,0.8639677304145045,1.4097928635429293,1.0195277293757135
Carabanchel,2012,25-39,19590,20357,39947,23464,63411,24068,23531,47599,18973,66572,0.813943825826824,0.8651141047979262,0.8392403201747936,1.2367047910188163,0.9525175749564382
Carabanchel,2013,25-39,18979,19961,38940,20687,59627,24068,23531,47599,18973,66572,0.7885574206415157,0.8482852407462497,0.8180844135380996,1.0903389026511359,0.8956768611428229
Carabanchel,2014,25-39,18220,19268,37488,17822,55310,24068,23531,47599,18973,66572,0.7570217716470001,0.8188347286558157,0.7875795709993908,0.9393348442523586,0.8308297782851649
Carabanchel,2015,25-39,17566,18850,36416,15791,52207,24068,23531,47599,18973,66572,0.7298487618414492,0.8010709277123794,0.7650580894556608,0.832287988193749,0.7842185903983657
Carabanchel,2016,25-39,16937,18291,35228,15740,50968,24068,23531,47599,18973,66572,0.7037144756523185,0.7773150312353916,0.74009958192399,0.8295999578348179,0.7656071621702818
Carabanchel,2017,25-39,16349,17506,33855,16068,49923,24068,23531,47599,18973,66572,0.6792836961941167,0.743954783052144,0.7112544381184479,0.8468876824961787,0.749909872018266
Carabanchel,2004,40-64,28073,32245,60318,8106,68424,28073,32245,60318,8106,68424,1.0,1.0,1.0,1.0,1.0
Carabanchel,2005,40-64,28403,32556,60959,9692,70651,28073,32245,60318,8106,68424,1.0117550671463684,1.0096449061870056,1.0106270101793826,1.1956575376264496,1.0325470595112827
Carabanchel,2006,40-64,28442,32398,60840,11561,72401,28073,32245,60318,8106,68424,1.0131443023545756,1.0047449216932858,1.0086541330945986,1.426227485812978,1.0581228808605168
Carabanchel,2007,40-64,28730,32721,61451,11972,73423,28073,32245,60318,8106,68424,1.0234032700459517,1.0147619786013335,1.0187837793030272,1.4769306686405133,1.0730591605284696
Carabanchel,2008,40-64,29021,33032,62053,12794,74847,28073,32245,60318,8106,68424,1.0337691019841129,1.0244068847883392,1.0287642163201698,1.5783370342955836,1.0938705717292179
Carabanchel,2009,40-64,29588,33459,63047,13903,76950,28073,32245,60318,8106,68424,1.0539664446265093,1.0376492479454178,1.045243542557777,1.7151492721440909,1.124605401613469
Carabanchel,2010,40-64,30223,33912,64135,14657,78792,28073,32245,60318,8106,68424,1.07658604352937,1.0516979376647542,1.0632812759043735,1.808166790032075,1.15152578042792
Carabanchel,2011,40-64,30712,34257,64969,15173,80142,28073,32245,60318,8106,68424,1.0940049157553522,1.0623972708947123,1.077107994296893,1.8718233407352578,1.171255699754472
Carabanchel,2012,40-64,31514,35088,66602,14309,80911,28073,32245,60318,8106,68424,1.1225732910625867,1.0881687083268723,1.1041811731158195,1.7652356279299284,1.1824944463930784
Carabanchel,2013,40-64,32409,36155,68564,13490,82054,28073,32245,60318,8106,68424,1.1544544580201617,1.1212591099395255,1.1367087768162074,1.6641993584998767,1.1991991114228926
Carabanchel,2014,40-64,33138,36877,70015,12690,82705,28073,32245,60318,8106,68424,1.1804224699889574,1.1436501783222206,1.1607646142113466,1.5655070318282753,1.2087133169648077
Carabanchel,2015,40-64,33916,37944,71860,11829,83689,28073,32245,60318,8106,68424,1.2081359313219107,1.1767405799348736,1.1913524984250141,1.4592894152479645,1.2230942359406056
Carabanchel,2016,40-64,34763,38692,73455,12623,86078,28073,32245,60318,8106,68424,1.238307270330923,1.1999379748798262,1.2177956828807321,1.5572415494695286,1.2580088857710745
Carabanchel,2017,40-64,35400,39534,74934,13410,88344,28073,32245,60318,8106,68424,1.2609981120649734,1.2260505504729415,1.2423157266487617,1.6543301258327165,1.2911259207295687
Carabanchel,2004,65-84,17615,25036,42651,601,43252,17615,25036,42651,601,43252,1.0,1.0,1.0,1.0,1.0
Carabanchel,2005,65-84,17285,24664,41949,712,42661,17615,25036,42651,601,43252,0.9812659665058189,0.9851413963891995,0.9835408313990294,1.1846921797004992,0.9863358919818737
Carabanchel,2006,65-84,17453,24946,42399,836,43235,17615,25036,42651,601,43252,0.9908032926483111,0.9964051765457741,0.9940915805022157,1.3910149750415974,0.9996069545916951
Carabanchel,2007,65-84,17247,24603,41850,661,42511,17615,25036,42651,601,43252,0.9791087141640648,0.9827049049368909,0.9812196665963283,1.0998336106489184,0.9828678442615371
Carabanchel,2008,65-84,16976,24469,41445,688,42133,17615,25036,42651,601,43252,0.9637240987794493,0.9773526122383768,0.9717239924034606,1.1447587354409319,0.9741283640062888
Carabanchel,2009,65-84,16801,24549,41350,682,42032,17615,25036,42651,601,43252,0.9537893840476867,0.9805480108643553,0.9694966120372325,1.13477537437604,0.9717932118745954
Carabanchel,2010,65-84,16696,24405,41101,715,41816,17615,25036,42651,601,43252,0.947828555208629,0.9747962933375939,0.9636585308668026,1.1896838602329451,0.9667992231573106
Carabanchel,2011,65-84,16694,24438,41132,741,41873,17615,25036,42651,601,43252,0.9477150156116946,0.97611439527081,0.9643853602494666,1.232945091514143,0.9681170812910386
Carabanchel,2012,65-84,16537,24167,40704,698,41402,17615,25036,42651,601,43252,0.9388021572523417,0.9652899824253075,0.9543504255468805,1.161397670549085,0.9572274114491816
Carabanchel,2013,65-84,16427,24040,40467,692,41159,17615,25036,42651,601,43252,0.932557479420948,0.9602172871065665,0.9487936976858691,1.151414309484193,0.9516091741422362
Carabanchel,2014,65-84,16326,23888,40214,646,40860,17615,25036,42651,601,43252,0.9268237297757593,0.9541460297172072,0.9428618320789665,1.0748752079866888,0.9446961990196985
Carabanchel,2015,65-84,16173,23641,39814,654,40468,17615,25036,42651,601,43252,0.9181379506102754,0.9442802364594983,0.9334833884316898,1.0881863560732112,0.9356330343105521
Carabanchel,2016,65-84,15936,23381,39317,788,40105,17615,25036,42651,601,43252,0.9046835083735453,0.9338951909250679,0.9218306721999484,1.3111480865224625,0.9272403588273375
Carabanchel,2017,65-84,15656,23005,38661,946,39607,17615,25036,42651,601,43252,0.8887879648027249,0.9188768173829686,0.9064500246184146,1.5740432612312811,0.9157264403958199
Carabanchel,2004,85-100,1421,3637,5058,29,5087,1421,3637,5058,29,5087,1.0,1.0,1.0,1.0,1.0
Carabanchel,2005,85-100,1429,3736,5165,31,5196,1421,3637,5058,29,5087,1.0056298381421533,1.0272202364586198,1.0211546065638593,1.0689655172413792,1.0214271672891684
Carabanchel,2006,85-100,1512,3831,5343,36,5379,1421,3637,5058,29,5087,1.064039408866995,1.053340665383558,1.0563463819691579,1.2413793103448276,1.0574012187930018
Carabanchel,2007,85-100,1777,4264,6041,34,6075,1421,3637,5058,29,5087,1.2505277973258269,1.1723948309045917,1.194345591142744,1.1724137931034482,1.194220562217417
Carabanchel,2008,85-100,1785,4262,6047,32,6079,1421,3637,5058,29,5087,1.2561576354679802,1.171844927137751,1.1955318307631475,1.103448275862069,1.1950068802830744
Carabanchel,2009,85-100,1911,4463,6374,41,6415,1421,3637,5058,29,5087,1.3448275862068966,1.2271102557052516,1.2601818900751285,1.4137931034482758,1.2610575977983094
Carabanchel,2010,85-100,2003,4584,6587,35,6622,1421,3637,5058,29,5087,1.409570724841661,1.26037943359912,1.3022933965994463,1.206896551724138,1.301749557696088
Carabanchel,2011,85-100,2127,4847,6974,41,7015,1421,3637,5058,29,5087,1.4968332160450386,1.3326917789386856,1.3788058521154607,1.4137931034482758,1.3790053076469433
Carabanchel,2012,85-100,2259,5091,7350,38,7388,1421,3637,5058,29,5087,1.58972554539057,1.3997800384932637,1.453143534994069,1.3103448275862069,1.4523294672695106
Carabanchel,2013,85-100,2363,5224,7587,41,7628,1421,3637,5058,29,5087,1.6629134412385644,1.436348638988177,1.5,1.4137931034482758,1.499508551208964
Carabanchel,2014,85-100,2495,5542,8037,45,8082,1421,3637,5058,29,5087,1.7558057705840957,1.5237833379158647,1.5889679715302492,1.5517241379310345,1.588755651661097
Carabanchel,2015,85-100,2658,5835,8493,48,8541,1421,3637,5058,29,5087,1.8705137227304716,1.6043442397580423,1.6791221826809015,1.6551724137931034,1.6789856496953017
Carabanchel,2016,85-100,2768,6004,8772,54,8826,1421,3637,5058,29,5087,1.947923997185081,1.65081110805609,1.734282325029656,1.8620689655172413,1.735010811873403
Carabanchel,2017,85-100,2888,6254,9142,54,9196,1421,3637,5058,29,5087,2.032371569317382,1.7195490789111905,1.8074337682878607,1.8620689655172413,1.807745232946727
Carabanchel,2004,Total,92282,104763,197045,41611,238656,92282,104763,197045,41611,238656,1.0,1.0,1.0,1.0,1.0
Carabanchel,2005,Total,91393,104161,195554,47269,242823,92282,104763,197045,41611,238656,0.9903664853384192,0.9942536964386282,0.9924332005379481,1.1359736608108433,1.017460277554304
Carabanchel,2006,Total,91230,104165,195395,53711,249106,92282,104763,197045,41611,238656,0.9886001603779718,0.9942918778576406,0.9916262782613109,1.2907884934272187,1.0437868731563422
Carabanchel,2007,Total,90683,103672,194355,53830,248185,92282,104763,197045,41611,238656,0.9826726772284953,0.9895860179643576,0.9863482960745007,1.2936483141477013,1.0399277621346206
Carabanchel,2008,Total,91167,104401,195568,58828,254396,92282,104763,197045,41611,238656,0.9879174703625843,0.9965445815793744,0.9925042502981553,1.4137607844079692,1.065952668275677
Carabanchel,2009,Total,91713,105211,196924,61186,258110,92282,104763,197045,41611,238656,0.9938341171626103,1.004276318929393,0.9993859270724962,1.4704284924659345,1.0815148163046393
Carabanchel,2010,Total,92054,105443,197497,60305,257802,92282,104763,197045,41611,238656,0.9975293123252639,1.0064908412321143,1.0022938922581137,1.4492562062916057,1.080224255832663
Carabanchel,2011,Total,92339,105922,198261,58544,256805,92282,104763,197045,41611,238656,1.0006176719186841,1.0110630661588538,1.0061711791722703,1.4069356660498427,1.0760466948243497
Carabanchel,2012,Total,92823,106584,199407,52289,251696,92282,104763,197045,41611,238656,1.005862465052773,1.0173820910054123,1.0119871095435053,1.2566148374227968,1.054639313488871
Carabanchel,2013,Total,93412,107695,201107,47331,248438,92282,104763,197045,41611,238656,1.0122450748791747,1.0279869801361168,1.0206145804257911,1.1374636514383216,1.0409878653794582
Carabanchel,2014,Total,93505,107914,201419,42154,243573,92282,104763,197045,41611,238656,1.0132528553780802,1.0300774128270478,1.0221979750818342,1.0130494340438827,1.0206028761061947
Carabanchel,2015,Total,93821,108922,202743,38110,240853,92282,104763,197045,41611,238656,1.0166771418044689,1.039699130418182,1.0289172524042731,0.915863593761265,1.0092057186913381
Carabanchel,2016,Total,94332,109346,203678,39065,242743,92282,104763,197045,41611,238656,1.022214516373724,1.0437463608335005,1.0336623613895304,0.93881425584581,1.0171250670421024
Carabanchel,2017,Total,94401,109512,203913,40796,244709,92282,104763,197045,41611,238656,1.0229622244858152,1.0453308897225166,1.0348549823644346,0.9804138328807287,1.0253628653794582
Centro,2004,0-24,5538,5335,10873,7749,18622,5538,5335,10873,7749,18622,1.0,1.0,1.0,1.0,1.0
Centro,2005,0-24,5244,5022,10266,7492,17758,5538,5335,10873,7749,18622,0.9469122426868906,0.9413308341143393,0.9441736411294032,0.9668344302490643,0.953603264955429
Centro,2006,0-24,4953,4713,9666,7254,16920,5538,5335,10873,7749,18622,0.8943661971830986,0.8834114339268978,0.8889910788190931,0.9361207897793263,0.9086027279561809
Centro,2007,0-24,4587,4437,9024,5485,14509,5538,5335,10873,7749,18622,0.8282773564463706,0.8316776007497657,0.8299457371470615,0.7078332688088785,0.7791322092149071
Centro,2008,0-24,4601,4468,9069,5978,15047,5538,5335,10873,7749,18622,0.8308053448898519,0.8374882849109653,0.8340844293203348,0.7714543812104788,0.8080227687681237
Centro,2009,0-24,4535,4414,8949,5908,14857,5538,5335,10873,7749,18622,0.8188876850848682,0.8273664479850047,0.8230479168582728,0.7624209575429087,0.7978197830523037
Centro,2010,0-24,4510,4366,8876,5384,14260,5538,5335,10873,7749,18622,0.8143734200072228,0.818369259606373,0.8163340384438518,0.6947993289456704,0.7657609279347009
Centro,2011,0-24,4494,4260,8754,4856,13610,5538,5335,10873,7749,18622,0.8114842903575298,0.7985004686035614,0.8051135841074221,0.6266615047102851,0.7308559768016325
Centro,2012,0-24,4521,4307,8828,4172,13000,5538,5335,10873,7749,18622,0.8163596966413867,0.8073102155576383,0.811919433459027,0.5383920505871725,0.6980990226613683
Centro,2013,0-24,4505,4331,8836,4083,12919,5538,5335,10873,7749,18622,0.8134705669916937,0.8118088097469541,0.8126552009564978,0.5269066976384049,0.6937493287509398
Centro,2014,0-24,4420,4256,8676,3897,12573,5538,5335,10873,7749,18622,0.7981220657276995,0.7977507029053421,0.7979398510070818,0.502903600464576,0.6751691547631833
Centro,2015,0-24,4368,4247,8615,3682,12297,5538,5335,10873,7749,18622,0.7887323943661971,0.7960637300843486,0.792329623838867,0.4751580849141825,0.6603479755128343
Centro,2016,0-24,4475,4300,8775,3673,12448,5538,5335,10873,7749,18622,0.8080534488985193,0.8059981255857545,0.8070449737882829,0.47399664472835207,0.6684566641606702
Centro,2017,0-24,4499,4285,8784,3403,12187,5538,5335,10873,7749,18622,0.8123871433730588,0.8031865042174321,0.8078727122229376,0.43915343915343913,0.6544409837826227
Centro,2004,25-39,15637,14735,30372,20424,50796,15637,14735,30372,20424,50796,1.0,1.0,1.0,1.0,1.0
Centro,2005,25-39,15608,14514,30122,21974,52096,15637,14735,30372,20424,50796,0.9981454243141268,0.9850016966406515,0.9917687343605953,1.0758911084998042,1.0255925663438066
Centro,2006,25-39,15316,14208,29524,23686,53210,15637,14735,30372,20424,50796,0.9794717656839548,0.964234815066169,0.9720795469511392,1.1597140618879749,1.0475234270414993
Centro,2007,25-39,14582,13475,28057,19537,47594,15637,14735,30372,20424,50796,0.9325318155656456,0.9144893111638955,0.9237784801791123,0.9565707011359186,0.9369635404362548
Centro,2008,25-39,14925,13909,28834,20022,48856,15637,14735,30372,20424,50796,0.9544669693675257,0.9439429928741092,0.9493612537863821,0.9803172737955347,0.9618080163792425
Centro,2009,25-39,14961,13996,28957,21153,50110,15637,14735,30372,20424,50796,0.9567692012534373,0.949847302341364,0.9534110364809694,1.0356933019976498,0.9864949996062682
Centro,2010,25-39,14909,14152,29061,21299,50360,15637,14735,30372,20424,50796,0.9534437551960094,0.9604343400067865,0.9568352429869617,1.0428417547982765,0.9914166469800771
Centro,2011,25-39,14891,14210,29101,20948,50049,15637,14735,30372,20424,50796,0.9522926392530536,0.9643705463182898,0.9581522454892665,1.0256560908734822,0.9852941176470589
Centro,2012,25-39,14871,14248,29119,18526,47645,15637,14735,30372,20424,50796,0.9510136215386583,0.966949440108585,0.9587448966153036,0.9070701135918527,0.9379675565005119
Centro,2013,25-39,14722,14026,28748,17477,46225,15637,14735,30372,20424,50796,0.941484939566413,0.9518832711231762,0.946529698406427,0.8557089698394046,0.910012599417277
Centro,2014,25-39,14151,13575,27726,15696,43422,15637,14735,30372,20424,50796,0.9049689838204259,0.9212758737699356,0.9128802844725405,0.7685076380728555,0.8548310890621309
Centro,2015,25-39,13745,13207,26952,14085,41037,15637,14735,30372,20424,50796,0.8790049242182004,0.8963013233797081,0.8873962860529435,0.6896298472385429,0.8078785731159934
Centro,2016,25-39,14129,13476,27605,14040,41645,15637,14735,30372,20424,50796,0.9035620643345911,0.9145571767899559,0.9088963519030686,0.6874265569917744,0.8198480195290968
Centro,2017,25-39,13783,13070,26853,14184,41037,15637,14735,30372,20424,50796,0.8814350578755515,0.8870037326094333,0.8841367048597393,0.6944770857814336,0.8078785731159934
Centro,2004,40-64,17403,18327,35730,9004,44734,17403,18327,35730,9004,44734,1.0,1.0,1.0,1.0,1.0
Centro,2005,40-64,17802,18575,36377,9969,46346,17403,18327,35730,9004,44734,1.0229270815376659,1.0135319474000108,1.018108032465715,1.1071745890715237,1.0360352304734655
Centro,2006,40-64,17905,18585,36490,10995,47485,17403,18327,35730,9004,44734,1.0288456013331035,1.0140775904403339,1.0212706409179961,1.2211239449133717,1.0614968480350517
Centro,2007,40-64,17908,18471,36379,9259,45638,17403,18327,35730,9004,44734,1.0290179854048154,1.0078572597806514,1.018164007836552,1.0283207463349622,1.0202083426476505
Centro,2008,40-64,18188,18594,36782,9155,45937,17403,18327,35730,9004,44734,1.0451071654312474,1.0145686691766247,1.0294430450601735,1.016770324300311,1.0268922966870837
Centro,2009,40-64,18463,18719,37182,9605,46787,17403,18327,35730,9004,44734,1.0609090386714934,1.0213892071806625,1.0406381192275398,1.0667481119502444,1.0458935038225958
Centro,2010,40-64,18880,18953,37833,9941,47774,17403,18327,35730,9004,44734,1.08487042463943,1.034157254324221,1.0588581024349286,1.1040648600621945,1.0679572584611257
Centro,2011,40-64,19271,19200,38471,10015,48486,17403,18327,35730,9004,44734,1.107337815319198,1.0476346374201997,1.076714245731878,1.1122834295868502,1.0838735637322843
Centro,2012,40-64,19881,19457,39338,9208,48546,17403,18327,35730,9004,44734,1.142389243233925,1.0616576635565014,1.1009795689896447,1.0226565970679697,1.0852148254124379
Centro,2013,40-64,20196,19718,39914,8910,48824,17403,18327,35730,9004,44734,1.1604895707636613,1.0758989469089322,1.1171004757906522,0.9895601954686806,1.0914293378638171
Centro,2014,40-64,20261,19575,39836,8454,48290,17403,18327,35730,9004,44734,1.1642245589840832,1.068096251432313,1.1149174363280157,0.9389160373167481,1.0794921089104483
Centro,2015,40-64,20585,19728,40313,7893,48206,17403,18327,35730,9004,44734,1.1828420387289549,1.0764445899492552,1.1282675622726002,0.8766103953798312,1.0776143425582332
Centro,2016,40-64,21097,20022,41119,8140,49259,17403,18327,35730,9004,44734,1.2122622536344307,1.092486495334752,1.1508256367198433,0.904042647712128,1.1011534850449323
Centro,2017,40-64,21440,20163,41603,8281,49884,17403,18327,35730,9004,44734,1.2319714991668103,1.1001800622033067,1.1643716764623566,0.9197023545091071,1.1151249608798677
Centro,2004,65-84,7942,14184,22126,702,22828,7942,14184,22126,702,22828,1.0,1.0,1.0,1.0,1.0
Centro,2005,65-84,7613,13524,21137,788,21925,7942,14184,22126,702,22828,0.958574666330899,0.9534686971235194,0.9553014553014553,1.1225071225071226,0.9604433152269143
Centro,2006,65-84,7494,13067,20561,931,21492,7942,14184,22126,702,22828,0.9435910350037774,0.9212492949802594,0.9292687336165597,1.3262108262108263,0.9414753811109164
Centro,2007,65-84,7211,12304,19515,668,20183,7942,14184,22126,702,22828,0.9079576932762529,0.8674562887760857,0.8819940341679472,0.9515669515669516,0.8841335202383038
Centro,2008,65-84,6951,11952,18903,642,19545,7942,14184,22126,702,22828,0.8752203475195165,0.8426395939086294,0.8543342673777456,0.9145299145299145,0.8561853863676188
Centro,2009,65-84,6857,11608,18465,712,19177,7942,14184,22126,702,22828,0.8633845378997733,0.8183869148336154,0.8345385519298563,1.0142450142450143,0.8400648326616436
Centro,2010,65-84,6805,11238,18043,742,18785,7942,14184,22126,702,22828,0.8568370687484261,0.7923011844331641,0.8154659676398807,1.056980056980057,0.8228929384965832
Centro,2011,65-84,6813,10966,17779,767,18546,7942,14184,22126,702,22828,0.8578443716947872,0.7731246474901298,0.8035343035343036,1.0925925925925926,0.8124233397581917
Centro,2012,65-84,6773,10750,17523,695,18218,7942,14184,22126,702,22828,0.8528078569629817,0.7578962210941906,0.7919642050076833,0.99002849002849,0.7980550201506922
Centro,2013,65-84,6765,10514,17279,707,17986,7942,14184,22126,702,22828,0.8518005540166205,0.7412577552171461,0.7809364548494984,1.0071225071225072,0.7878920623795339
Centro,2014,65-84,6802,10342,17144,692,17836,7942,14184,22126,702,22828,0.8564593301435407,0.729131415679639,0.7748350357046009,0.9857549857549858,0.7813211845102506
Centro,2015,65-84,6724,10059,16783,678,17461,7942,14184,22126,702,22828,0.8466381264165198,0.7091793570219966,0.7585193889541716,0.9658119658119658,0.7648939898370423
Centro,2016,65-84,6688,9866,16554,759,17313,7942,14184,22126,702,22828,0.8421052631578947,0.6955724760293288,0.7481695742565307,1.0811965811965811,0.7584107236726827
Centro,2017,65-84,6683,9705,16388,803,17191,7942,14184,22126,702,22828,0.841475698816419,0.6842216582064298,0.7406670884931754,1.1438746438746439,0.7530664096723322
Centro,2004,85-100,926,3533,4459,65,4524,926,3533,4459,65,4524,1.0,1.0,1.0,1.0,1.0
Centro,2005,85-100,915,3508,4423,63,4486,926,3533,4459,65,4524,0.9881209503239741,0.9929238607415793,0.9919264409060328,0.9692307692307692,0.9916003536693192
Centro,2006,85-100,913,3464,4377,61,4438,926,3533,4459,65,4524,0.9859611231101512,0.9804698556467591,0.9816102265081857,0.9384615384615385,0.9809902740937224
Centro,2007,85-100,976,3613,4589,38,4627,926,3533,4459,65,4524,1.0539956803455723,1.0226436456269459,1.0291545189504374,0.5846153846153846,1.0227674624226348
Centro,2008,85-100,934,3438,4372,41,4413,926,3533,4459,65,4524,1.0086393088552916,0.9731106708180017,0.9804888988562458,0.6307692307692307,0.9754641909814323
Centro,2009,85-100,964,3416,4380,46,4426,926,3533,4459,65,4524,1.041036717062635,0.9668836682705916,0.9822830230993497,0.7076923076923077,0.9783377541998232
Centro,2010,85-100,1007,3488,4495,46,4541,926,3533,4459,65,4524,1.0874730021598271,0.9872629493348429,1.0080735590939673,0.7076923076923077,1.0037577365163572
Centro,2011,85-100,1028,3456,4484,51,4535,926,3533,4459,65,4524,1.1101511879049677,0.9782054910840645,1.0056066382596995,0.7846153846153846,1.0024314765694076
Centro,2012,85-100,1033,3504,4537,44,4581,926,3533,4459,65,4524,1.1155507559395248,0.9917916784602321,1.0174927113702623,0.676923076923077,1.0125994694960212
Centro,2013,85-100,1111,3367,4478,44,4522,926,3533,4459,65,4524,1.1997840172786176,0.9530144353240871,1.0042610450773717,0.676923076923077,0.9995579133510168
Centro,2014,85-100,1147,3356,4503,41,4544,926,3533,4459,65,4524,1.2386609071274297,0.9499009340503821,1.009867683337071,0.6307692307692307,1.004420866489832
Centro,2015,85-100,1183,3381,4564,40,4604,926,3533,4459,65,4524,1.2775377969762418,0.9569770733088028,1.0235478806907379,0.6153846153846154,1.0176834659593281
Centro,2016,85-100,1207,3339,4546,47,4593,926,3533,4459,65,4524,1.3034557235421167,0.9450891593546561,1.019511101143754,0.7230769230769231,1.0152519893899203
Centro,2017,85-100,1217,3280,4497,49,4546,926,3533,4459,65,4524,1.3142548596112311,0.9283894707047835,1.0085220901547431,0.7538461538461538,1.0048629531388151
Centro,2004,Total,50815,59380,110195,41371,151566,50815,59380,110195,41371,151566,1.0,1.0,1.0,1.0,1.0
Centro,2005,Total,50569,58433,109002,43561,152563,50815,59380,110195,41371,151566,0.995158909770737,0.9840518693162681,0.9891737374654023,1.052935631239274,1.0065779924257419
Centro,2006,Total,49979,57322,107301,46112,153413,50815,59380,110195,41371,151566,0.9835481649119354,0.9653418659481307,0.9737374654022415,1.1145971816006381,1.0121861103413694
Centro,2007,Total,48552,55461,104013,37284,141297,50815,59380,110195,41371,151566,0.9554659057364951,0.934001347254968,0.9438994509732747,0.9012109932078025,0.9322473377934365
Centro,2008,Total,48922,55598,104520,38192,142712,50815,59380,110195,41371,151566,0.9627472203089639,0.9363085213876726,0.948500385679931,0.9231587343791545,0.9415832046765106
Centro,2009,Total,49179,55446,104625,39850,144475,50815,59380,110195,41371,151566,0.9678047820525435,0.9337487369484675,0.9494532419801262,0.9632351163858741,0.9532151010121004
Centro,2010,Total,49518,55497,105015,39746,144761,50815,59380,110195,41371,151566,0.9744760405392109,0.9346076119905692,0.952992422523708,0.9607212781900365,0.9551020677460644
Centro,2011,Total,49896,55445,105341,38923,144264,50815,59380,110195,41371,151566,0.9819147889402735,0.9337318962613674,0.9559508144652661,0.9408281163133596,0.9518229682118681
Centro,2012,Total,50379,55588,105967,34794,140761,50815,59380,110195,41371,151566,0.9914198563416314,0.9361401145166722,0.9616316529788103,0.8410239056343816,0.9287109246136996
Centro,2013,Total,50608,55239,105847,33197,139044,50815,59380,110195,41371,151566,0.9959263996851323,0.9302627147187605,0.9605426743500158,0.8024219864156051,0.9173825264241321
Centro,2014,Total,50058,54301,104359,30578,134937,50815,59380,110195,41371,151566,0.9851028239693004,0.914466150218929,0.9470393393529652,0.7391167726185008,0.8902854202129765
Centro,2015,Total,49824,53769,103593,27975,131568,50815,59380,110195,41371,151566,0.9804978844829283,0.905506904681711,0.9400880257724942,0.6761983031592178,0.8680574799097422
Centro,2016,Total,50790,54126,104916,28217,133133,50815,59380,110195,41371,151566,0.999508019285644,0.9115190299764231,0.9520940151549526,0.6820478112687631,0.87838301466028
Centro,2017,Total,50710,53512,104222,28200,132422,50815,59380,110195,41371,151566,0.9979336809997048,0.9011788480970023,0.9457960887517582,0.6816368954098282,0.8736919889685022
Chamartín,2004,0-24,9239,8878,18117,2802,20919,9239,8878,18117,2802,20919,1.0,1.0,1.0,1.0,1.0
Chamartín,2005,0-24,8961,8558,17519,2828,20347,9239,8878,18117,2802,20919,0.9699101634376015,0.9639558459112413,0.9669923276480653,1.0092790863668808,0.9726564367321574
Chamartín,2006,0-24,8786,8405,17191,2920,20111,9239,8878,18117,2802,20919,0.9509687195583938,0.9467222347375535,0.9488877849533587,1.0421127765881513,0.9613748267125579
Chamartín,2007,0-24,8725,8250,16975,2510,19485,9239,8878,18117,2802,20919,0.9443662734062128,0.929263347600811,0.9369652812275763,0.8957887223411849,0.9314498781012477
Chamartín,2008,0-24,8713,8278,16991,2687,19678,9239,8878,18117,2802,20919,0.94306743154021,0.9324172110835773,0.9378484296517083,0.9589578872234118,0.9406759405325302
Chamartín,2009,0-24,8694,8165,16859,2621,19480,9239,8878,18117,2802,20919,0.9410109319190388,0.9196891191709845,0.930562455152619,0.9354032833690221,0.9312108609398155
Chamartín,2010,0-24,8609,8060,16669,2371,19040,9239,8878,18117,2802,20919,0.9318108020348522,0.9078621311106105,0.9200750676160512,0.8461812990720914,0.9101773507337827
Chamartín,2011,0-24,8525,8070,16595,2178,18773,9239,8878,18117,2802,20919,0.9227189089728326,0.9089885109258842,0.9159905061544406,0.7773019271948608,0.8974138343133037
Chamartín,2012,0-24,8447,8048,16495,1833,18328,9239,8878,18117,2802,20919,0.9142764368438142,0.906510475332282,0.9104708285036154,0.6541755888650964,0.8761413069458387
Chamartín,2013,0-24,8437,8039,16476,1608,18084,9239,8878,18117,2802,20919,0.9131940686221452,0.9054967334985357,0.9094220897499586,0.5738758029978587,0.8644772694679478
Chamartín,2014,0-24,8347,7970,16317,1485,17802,9239,8878,18117,2802,20919,0.9034527546271242,0.8977247127731471,0.9006458022851466,0.5299785867237687,0.8509967015631722
Chamartín,2015,0-24,8216,7895,16111,1363,17474,9239,8878,18117,2802,20919,0.8892737309232601,0.8892768641585943,0.8892752663244466,0.48643825838686655,0.8353171757732205
Chamartín,2016,0-24,8243,8047,16290,1404,17694,9239,8878,18117,2802,20919,0.8921961251217664,0.9063978373507546,0.8991554893194238,0.5010706638115632,0.8458339308762369
Chamartín,2017,0-24,8308,8077,16385,1434,17819,9239,8878,18117,2802,20919,0.899231518562615,0.9097769767965758,0.9043991830877077,0.5117773019271948,0.8518093599120417
Chamartín,2004,25-39,13772,14464,28236,6827,35063,13772,14464,28236,6827,35063,1.0,1.0,1.0,1.0,1.0
Chamartín,2005,25-39,13249,13785,27034,7526,34560,13772,14464,28236,6827,35063,0.9620243973279117,0.9530558628318584,0.9574302309108939,1.1023875787315072,0.985654393520235
Chamartín,2006,25-39,12765,13287,26052,8188,34240,13772,14464,28236,6827,35063,0.9268806273598605,0.9186255530973452,0.9226519337016574,1.1993555002197158,0.9765279639506032
Chamartín,2007,25-39,13103,13515,26618,7380,33998,13772,14464,28236,6827,35063,0.9514231774615162,0.9343888274336283,0.9426972659016858,1.0810019042038963,0.9696261015885691
Chamartín,2008,25-39,13240,13678,26918,7688,34606,13772,14464,28236,6827,35063,0.9613708974731339,0.9456581858407079,0.9533220002833263,1.1261168888237878,0.9869663177708696
Chamartín,2009,25-39,13255,13714,26969,8106,35075,13772,14464,28236,6827,35063,0.9624600638977636,0.9481471238938053,0.9551282051282052,1.1873443679507836,1.0003422411088612
Chamartín,2010,25-39,13083,13540,26623,8121,34744,13772,14464,28236,6827,35063,0.9499709555620098,0.9361172566371682,0.9428743448080464,1.1895415262926614,0.9909020905227733
Chamartín,2011,25-39,12979,13302,26281,7996,34277,13772,14464,28236,6827,35063,0.9424194016845774,0.9196626106194691,0.9307621476129764,1.1712318734436795,0.9775832073695919
Chamartín,2012,25-39,13030,13187,26217,7279,33496,13772,14464,28236,6827,35063,0.9461225675283184,0.9117118362831859,0.9284955376115597,1.066207704701919,0.9553090152012093
Chamartín,2013,25-39,12871,12962,25833,6991,32824,13772,14464,28236,6827,35063,0.9345774034272437,0.8961559734513275,0.9148958776030599,1.0240222645378643,0.9361435131049824
Chamartín,2014,25-39,12607,12856,25463,6034,31497,13772,14464,28236,6827,35063,0.9154080743537613,0.8888274336283186,0.90179203853237,0.8838435623260583,0.8982973504834155
Chamartín,2015,25-39,12354,12751,25105,5360,30465,13772,14464,28236,6827,35063,0.8970374673250072,0.8815680309734514,0.8891131888369458,0.7851179141643474,0.868864615121353
Chamartín,2016,25-39,12346,12635,24981,5401,30382,13772,14464,28236,6827,35063,0.8964565785652048,0.8735481194690266,0.8847216319592011,0.7911234802988135,0.8664974474517297
Chamartín,2017,25-39,12227,12573,24800,5347,30147,13772,14464,28236,6827,35063,0.8878158582631426,0.8692616150442478,0.8783113755489446,0.7832137102680533,0.8597952257365313
Chamartín,2004,40-64,18295,23452,41747,4253,46000,18295,23452,41747,4253,46000,1.0,1.0,1.0,1.0,1.0
Chamartín,2005,40-64,18484,23629,42113,4729,46842,18295,23452,41747,4253,46000,1.0103306914457502,1.0075473307180625,1.008767097036913,1.1119209969433341,1.018304347826087
Chamartín,2006,40-64,18532,23490,42022,5332,47354,18295,23452,41747,4253,46000,1.0129543591145123,1.0016203308886236,1.006587299686205,1.2537032682812133,1.0294347826086956
Chamartín,2007,40-64,19294,23941,43235,4795,48030,18295,23452,41747,4253,46000,1.0546050833561083,1.0208511001193927,1.0356432797566293,1.127439454502704,1.0441304347826086
Chamartín,2008,40-64,19544,24175,43719,4852,48571,18295,23452,41747,4253,46000,1.06827001913091,1.0308289271703905,1.04723692720435,1.1408417587585233,1.0558913043478262
Chamartín,2009,40-64,19637,24258,43895,5149,49044,18295,23452,41747,4253,46000,1.0733533752391364,1.0343680709534369,1.0514527990035212,1.2106748177756876,1.0661739130434782
Chamartín,2010,40-64,19703,24274,43977,5295,49272,18295,23452,41747,4253,46000,1.0769609182836841,1.0350503155381203,1.0534170120008624,1.2450035269221726,1.0711304347826087
Chamartín,2011,40-64,19883,24374,44257,5460,49717,18295,23452,41747,4253,46000,1.0867996720415414,1.0393143441923929,1.0601240807722712,1.2837996708205972,1.080804347826087
Chamartín,2012,40-64,19978,24470,44448,4900,49348,18295,23452,41747,4253,46000,1.091992347635966,1.0434078117004946,1.0646992598270535,1.1521279097107924,1.0727826086956522
Chamartín,2013,40-64,20045,24478,44523,4829,49352,18295,23452,41747,4253,46000,1.095654550423613,1.0437489339928365,1.0664957961051094,1.1354338114272278,1.0728695652173914
Chamartín,2014,40-64,19987,24327,44314,4524,48838,18295,23452,41747,4253,46000,1.092484285323859,1.0373102507248848,1.0614894483435935,1.0637197272513519,1.0616956521739132
Chamartín,2015,40-64,20096,24297,44393,4202,48595,18295,23452,41747,4253,46000,1.0984421973216727,1.0360310421286032,1.0633817998898125,0.9880084646132142,1.0564130434782608
Chamartín,2016,40-64,20369,24588,44957,4204,49161,18295,23452,41747,4253,46000,1.1133643071877561,1.0484393655125361,1.0768917527007928,0.9884787209028921,1.0687173913043477
Chamartín,2017,40-64,20542,24641,45183,4314,49497,18295,23452,41747,4253,46000,1.122820442743919,1.0506993006993006,1.0823053153520013,1.0143428168351751,1.0760217391304348
Chamartín,2004,65-84,9556,14997,24553,741,25294,9556,14997,24553,741,25294,1.0,1.0,1.0,1.0,1.0
Chamartín,2005,65-84,9385,14833,24218,819,25037,9556,14997,24553,741,25294,0.9821054834658853,0.9890644795625791,0.9863560461043457,1.105263157894737,0.9898394876255239
Chamartín,2006,65-84,9498,14996,24494,878,25372,9556,14997,24553,741,25294,0.993930514859774,0.9999333199973328,0.9975970349855415,1.1848852901484481,1.0030837352731874
Chamartín,2007,65-84,9629,15198,24827,711,25538,9556,14997,24553,741,25294,1.007639179573043,1.0134026805361072,1.0111595324400278,0.9595141700404858,1.0096465564956116
Chamartín,2008,65-84,9635,15184,24819,704,25523,9556,14997,24553,741,25294,1.0082670573461698,1.0124691604987663,1.0108337066753554,0.9500674763832658,1.0090535304815371
Chamartín,2009,65-84,9637,15215,24852,726,25578,9556,14997,24553,741,25294,1.0084763499372122,1.0145362405814495,1.0121777379546288,0.979757085020243,1.0112279591998101
Chamartín,2010,65-84,9701,15337,25038,760,25798,9556,14997,24553,741,25294,1.0151737128505651,1.022671200906848,1.0197531869832608,1.0256410256410255,1.0199256740729026
Chamartín,2011,65-84,9814,15434,25248,792,26040,9556,14997,24553,741,25294,1.0269987442444537,1.0291391611655665,1.0283061133059097,1.0688259109311742,1.0294931604333044
Chamartín,2012,65-84,9866,15422,25288,723,26011,9556,14997,24553,741,25294,1.032440351611553,1.02833900113356,1.0299352421292713,0.9757085020242915,1.0283466434727604
Chamartín,2013,65-84,9990,15430,25420,719,26139,9556,14997,24553,741,25294,1.0454164922561742,1.0288724411548977,1.035311367246365,0.970310391363023,1.033407132126196
Chamartín,2014,65-84,10054,15498,25552,696,26248,9556,14997,24553,741,25294,1.052113855169527,1.0334066813362672,1.0406874923634586,0.9392712550607287,1.0377164544951372
Chamartín,2015,65-84,10113,15632,25745,698,26443,9556,14997,24553,741,25294,1.0582879866052741,1.042341801693672,1.048548038936179,0.941970310391363,1.0454257926781054
Chamartín,2016,65-84,10169,15632,25801,706,26507,9556,14997,24553,741,25294,1.064148179154458,1.042341801693672,1.0508288192888853,0.9527665317139001,1.0479560370048233
Chamartín,2017,65-84,10262,15638,25900,745,26645,9556,14997,24553,741,25294,1.0738802846379238,1.0427418817096752,1.0548609131267055,1.0053981106612686,1.0534118763343086
Chamartín,2004,85-100,1072,2741,3813,137,3950,1072,2741,3813,137,3950,1.0,1.0,1.0,1.0,1.0
Chamartín,2005,85-100,1093,2830,3923,147,4070,1072,2741,3813,137,3950,1.0195895522388059,1.0324699014958045,1.02884867558353,1.072992700729927,1.030379746835443
Chamartín,2006,85-100,1123,2906,4029,154,4183,1072,2741,3813,137,3950,1.0475746268656716,1.060197008391098,1.056648308418568,1.1240875912408759,1.0589873417721518
Chamartín,2007,85-100,1310,3225,4535,121,4656,1072,2741,3813,137,3950,1.2220149253731343,1.1765778912805545,1.1893522161028063,0.8832116788321168,1.1787341772151898
Chamartín,2008,85-100,1334,3246,4580,107,4687,1072,2741,3813,137,3950,1.2444029850746268,1.1842393287121489,1.2011539470233412,0.781021897810219,1.1865822784810127
Chamartín,2009,85-100,1464,3407,4871,113,4984,1072,2741,3813,137,3950,1.3656716417910448,1.2429770156877051,1.2774718069761344,0.8248175182481752,1.2617721518987342
Chamartín,2010,85-100,1586,3557,5143,122,5265,1072,2741,3813,137,3950,1.4794776119402986,1.2977015687705218,1.3488067138735904,0.8905109489051095,1.3329113924050633
Chamartín,2011,85-100,1674,3750,5424,117,5541,1072,2741,3813,137,3950,1.5615671641791045,1.3681138270704123,1.4225019669551535,0.8540145985401459,1.4027848101265823
Chamartín,2012,85-100,1733,3928,5661,108,5769,1072,2741,3813,137,3950,1.6166044776119404,1.4330536300620211,1.4846577498033044,0.7883211678832117,1.460506329113924
Chamartín,2013,85-100,1761,4089,5850,114,5964,1072,2741,3813,137,3950,1.642723880597015,1.4917913170375776,1.5342250196695515,0.8321167883211679,1.509873417721519
Chamartín,2014,85-100,1822,4277,6099,118,6217,1072,2741,3813,137,3950,1.6996268656716418,1.5603794235680408,1.5995279307631787,0.8613138686131386,1.5739240506329113
Chamartín,2015,85-100,1869,4444,6313,110,6423,1072,2741,3813,137,3950,1.7434701492537314,1.6213060926669098,1.6556517178075008,0.8029197080291971,1.6260759493670887
Chamartín,2016,85-100,1957,4585,6542,118,6660,1072,2741,3813,137,3950,1.8255597014925373,1.6727471725647574,1.7157094151586678,0.8613138686131386,1.6860759493670887
Chamartín,2017,85-100,2012,4707,6719,117,6836,1072,2741,3813,137,3950,1.876865671641791,1.7172564757387814,1.7621295567794388,0.8540145985401459,1.730632911392405
Chamartín,2004,Total,57772,70010,127782,15869,143651,57772,70010,127782,15869,143651,1.0,1.0,1.0,1.0,1.0
Chamartín,2005,Total,57090,69076,126166,17246,143412,57772,70010,127782,15869,143651,0.9881949733434882,0.9866590487073276,0.9873534613638854,1.08677295355725,0.9983362454838463
Chamartín,2006,Total,56651,68498,125149,18714,143863,57772,70010,127782,15869,143651,0.9805961365367306,0.9784030852735324,0.9793945939177662,1.1792803579305564,1.00147579898504
Chamartín,2007,Total,57737,69431,127168,16543,143711,57772,70010,127782,15869,143651,0.9993941701862494,0.9917297528924439,0.9951949413845456,1.0424727456046379,1.0004176789580301
Chamartín,2008,Total,58297,70044,128341,17123,145464,57772,70010,127782,15869,143651,1.009087447206259,1.0004856449078703,1.0043746380554381,1.0790219925641187,1.01262086584848
Chamartín,2009,Total,58662,70424,129086,17836,146922,57772,70010,127782,15869,143651,1.0154053866925155,1.005913440937009,1.0102048801865677,1.1239523599470667,1.0227704645286144
Chamartín,2010,Total,58703,70451,129154,17754,146908,57772,70010,127782,15869,143651,1.0161150730457662,1.006299100128553,1.0107370365153152,1.1187850526183125,1.0226730061050742
Chamartín,2011,Total,58940,70700,129640,17574,147214,57772,70010,127782,15869,143651,1.0202174063560203,1.009855734895015,1.0145403891001863,1.1074421828722667,1.0248031687910282
Chamartín,2012,Total,59072,70842,129914,15805,145719,57772,70010,127782,15869,143651,1.0225022502250225,1.0118840165690615,1.0166846660719038,0.9959669796458503,1.0143960014201086
Chamartín,2013,Total,59156,70792,129948,15193,145141,57772,70010,127782,15869,143651,1.023956241778024,1.011169832881017,1.0169507442362775,0.9574012225092948,1.010372360791084
Chamartín,2014,Total,58713,70691,129404,13720,143124,57772,70010,127782,15869,143651,1.0162881672782662,1.009727181831167,1.0126934936062981,0.8645787384208204,0.9963313864853012
Chamartín,2015,Total,58494,70793,129287,12451,141738,57772,70010,127782,15869,143651,1.0124974035865124,1.011184116554778,1.0117778716877182,0.784611506711198,0.986683002554803
Chamartín,2016,Total,59086,71373,130459,12610,143069,57772,70010,127782,15869,143651,1.0227445821505228,1.0194686473360948,1.0209497425302467,0.7946310416535384,0.9959485141071068
Chamartín,2017,Total,59449,71600,131049,12767,143816,57772,70010,127782,15869,143651,1.0290279027902791,1.0227110412798173,1.0255669812649668,0.8045245447098116,1.0011486171345831
Chamberí,2004,0-24,8128,8169,16297,4063,20360,8128,8169,16297,4063,20360,1.0,1.0,1.0,1.0,1.0
Chamberí,2005,0-24,7764,7785,15549,3904,19453,8128,8169,16297,4063,20360,0.9552165354330708,0.9529930224017628,0.95410198195987,0.9608663549101649,0.9554518664047151
Chamberí,2006,0-24,7467,7473,14940,3902,18842,8128,8169,16297,4063,20360,0.9186761811023622,0.914799853103195,0.9167331410689084,0.9603741078021166,0.925442043222004
Chamberí,2007,0-24,7083,7044,14127,3088,17215,8128,8169,16297,4063,20360,0.8714320866141733,0.8622842453176643,0.866846658894275,0.7600295348264829,0.8455304518664047
Chamberí,2008,0-24,7069,7020,14089,3387,17476,8128,8169,16297,4063,20360,0.8697096456692913,0.8593463092177746,0.8645149414002578,0.8336204774796948,0.8583497053045187
Chamberí,2009,0-24,6911,6915,13826,3287,17113,8128,8169,16297,4063,20360,0.8502706692913385,0.8464928387807565,0.8483770019021906,0.8090081220772828,0.8405206286836935
Chamberí,2010,0-24,6846,6747,13593,2915,16508,8128,8169,16297,4063,20360,0.8422736220472441,0.8259272860815278,0.8340798920046635,0.7174501599803101,0.8108055009823183
Chamberí,2011,0-24,6743,6663,13406,2581,15987,8128,8169,16297,4063,20360,0.8296013779527559,0.8156445097319134,0.822605387494631,0.635244892936254,0.7852161100196464
Chamberí,2012,0-24,6697,6573,13270,2263,15533,8128,8169,16297,4063,20360,0.8239419291338582,0.8046272493573264,0.8142602933055163,0.5569776027565838,0.762917485265226
Chamberí,2013,0-24,6738,6630,13368,2443,15811,8128,8169,16297,4063,20360,0.828986220472441,0.8116048475945649,0.8202736700006136,0.6012798424809255,0.7765717092337917
Chamberí,2014,0-24,6645,6464,13109,2384,15493,8128,8169,16297,4063,20360,0.8175442913385826,0.7912841229036601,0.8043811744492851,0.5867585527935023,0.7609528487229863
Chamberí,2015,0-24,6654,6526,13180,2193,15373,8128,8169,16297,4063,20360,0.8186515748031497,0.7988737911617089,0.8087378045038964,0.5397489539748954,0.7550589390962672
Chamberí,2016,0-24,6760,6685,13445,2108,15553,8128,8169,16297,4063,20360,0.8316929133858267,0.818337617823479,0.8249984659753329,0.5188284518828452,0.7638998035363458
Chamberí,2017,0-24,6771,6704,13475,1996,15471,8128,8169,16297,4063,20360,0.8330462598425197,0.8206634839025585,0.8268392955758729,0.49126261383214376,0.7598722986247545
Chamberí,2004,25-39,14379,15120,29499,9959,39458,14379,15120,29499,9959,39458,1.0,1.0,1.0,1.0,1.0
Chamberí,2005,25-39,14199,14925,29124,10835,39959,14379,15120,29499,9959,39458,0.9874817442103067,0.9871031746031746,0.9872877046679548,1.0879606386183351,1.0126970449591972
Chamberí,2006,25-39,13787,14370,28157,11772,39929,14379,15120,29499,9959,39458,0.9588288476250086,0.9503968253968254,0.9545069324383877,1.1820463901998193,1.0119367428658321
Chamberí,2007,25-39,13027,13628,26655,9808,36463,14379,15120,29499,9959,39458,0.9059739898463036,0.9013227513227513,0.9035899522017695,0.9848378351240085,0.9240965076790512
Chamberí,2008,25-39,13175,13925,27100,10066,37166,14379,15120,29499,9959,39458,0.9162667779400515,0.9209656084656085,0.9186752093291298,1.0107440506074907,0.9419129200669066
Chamberí,2009,25-39,13041,13988,27029,10350,37379,14379,15120,29499,9959,39458,0.9069476319632798,0.9251322751322751,0.9162683480795959,1.0392609699769053,0.9473110649297988
Chamberí,2010,25-39,12931,14077,27008,10211,37219,14379,15120,29499,9959,39458,0.8992975867584672,0.9310185185185185,0.9155564595410014,1.0253037453559595,0.9432561204318516
Chamberí,2011,25-39,12975,14066,27041,10007,37048,14379,15120,29499,9959,39458,0.9023576048403923,0.9302910052910053,0.9166751415302213,1.0048197610201828,0.9389223984996705
Chamberí,2012,25-39,12896,14027,26923,8779,35702,14379,15120,29499,9959,39458,0.8968634814660268,0.9277116402116402,0.9126750059324045,0.8815142082538407,0.9048101779106899
Chamberí,2013,25-39,12821,14032,26853,8482,35335,14379,15120,29499,9959,39458,0.8916475415536547,0.928042328042328,0.9103020441370894,0.85169193694146,0.8955091489685235
Chamberí,2014,25-39,12538,13747,26285,7619,33904,14379,15120,29499,9959,39458,0.8719660616176368,0.9091931216931217,0.8910471541408184,0.765036650266091,0.8592427391150084
Chamberí,2015,25-39,12472,13695,26167,6829,32996,14379,15120,29499,9959,39458,0.8673760344947493,0.9057539682539683,0.8870470185430015,0.6857114168089166,0.8362309290891581
Chamberí,2016,25-39,12552,13656,26208,6588,32796,14379,15120,29499,9959,39458,0.8729397037346129,0.9031746031746032,0.8884368961659718,0.6615122000200824,0.8311622484667242
Chamberí,2017,25-39,12531,13576,26107,6583,32690,14379,15120,29499,9959,39458,0.8714792405591487,0.8978835978835978,0.8850130512898743,0.66101014158048,0.8284758477368341
Chamberí,2004,40-64,18278,24104,42382,4968,47350,18278,24104,42382,4968,47350,1.0,1.0,1.0,1.0,1.0
Chamberí,2005,40-64,18736,24288,43024,5683,48707,18278,24104,42382,4968,47350,1.0250574461100777,1.0076335877862594,1.0151479401632768,1.1439210950080516,1.0286589229144667
Chamberí,2006,40-64,18701,24165,42866,6429,49295,18278,24104,42382,4968,47350,1.0231425757741548,1.0025307002987056,1.0114199424283894,1.2940821256038648,1.041077085533263
Chamberí,2007,40-64,18488,23974,42462,5631,48093,18278,24104,42382,4968,47350,1.0114892220155378,0.994606704281447,1.0018875937898164,1.1334541062801933,1.0156916578669481
Chamberí,2008,40-64,18656,23969,42625,5619,48244,18278,24104,42382,4968,47350,1.020680599627968,0.9943992698307335,1.0057335661365674,1.1310386473429952,1.0188806758183737
Chamberí,2009,40-64,18692,23961,42653,5838,48491,18278,24104,42382,4968,47350,1.0226501805449173,0.9940673747095917,1.0063942239630033,1.1751207729468598,1.0240971488912354
Chamberí,2010,40-64,18698,23798,42496,5950,48446,18278,24104,42382,4968,47350,1.0229784440310756,0.9873050116163292,1.0026898211504884,1.1976650563607085,1.0231467793030622
Chamberí,2011,40-64,18687,23651,42338,5990,48328,18278,24104,42382,4968,47350,1.0223766276397854,0.9812064387653502,0.9989618234156009,1.2057165861513688,1.0206546990496304
Chamberí,2012,40-64,18674,23604,42278,5290,47568,18278,24104,42382,4968,47350,1.0216653900864427,0.9792565549286425,0.9975461280732386,1.0648148148148149,1.0046040126715945
Chamberí,2013,40-64,18764,23601,42365,4974,47339,18278,24104,42382,4968,47350,1.0265893423788162,0.9791320942582145,0.999598886319664,1.001207729468599,0.9997676874340021
Chamberí,2014,40-64,18728,23248,41976,4560,46536,18278,24104,42382,4968,47350,1.0246197614618666,0.964487222037836,0.9904204615166816,0.9178743961352657,0.9828088701161563
Chamberí,2015,40-64,18633,23258,41891,4289,46180,18278,24104,42382,4968,47350,1.0194222562643616,0.9649020909392632,0.9884148931150016,0.8633252818035426,0.9752903907074973
Chamberí,2016,40-64,18780,23375,42155,4313,46468,18278,24104,42382,4968,47350,1.027464711675238,0.9697560570859608,0.9946439526213958,0.8681561996779388,0.9813727560718057
Chamberí,2017,40-64,18799,23248,42047,4322,46369,18278,24104,42382,4968,47350,1.028504212714739,0.964487222037836,0.9920957010051437,0.8699677938808373,0.9792819429778247
Chamberí,2004,65-84,9927,18458,28385,611,28996,9927,18458,28385,611,28996,1.0,1.0,1.0,1.0,1.0
Chamberí,2005,65-84,9592,17915,27507,647,28154,9927,18458,28385,611,28996,0.9662536516570968,0.9705818615234587,0.9690681698079971,1.0589198036006546,0.9709615119326803
Chamberí,2006,65-84,9620,17658,27278,712,27990,9927,18458,28385,611,28996,0.9690742419663544,0.9566583595189078,0.961000528448124,1.165302782324059,0.9653055593875017
Chamberí,2007,65-84,9524,17167,26691,568,27259,9927,18458,28385,611,28996,0.9594036466203284,0.9300574276736374,0.9403205918618989,0.9296235679214403,0.9400951855428334
Chamberí,2008,65-84,9435,16968,26403,550,26953,9927,18458,28385,611,28996,0.9504381988516168,0.9192761946039658,0.930174387880923,0.900163666121113,0.9295420057939026
Chamberí,2009,65-84,9430,16774,26204,531,26735,9927,18458,28385,611,28996,0.949934522010678,0.9087658467873009,0.9231636427690681,0.8690671031096563,0.9220237274106773
Chamberí,2010,65-84,9413,16640,26053,545,26598,9927,18458,28385,611,28996,0.9482220207514859,0.901506122006718,0.9178439316540427,0.8919803600654664,0.917298937784522
Chamberí,2011,65-84,9425,16526,25951,569,26520,9927,18458,28385,611,28996,0.9494308451697391,0.8953299382381623,0.9142504844107804,0.9312602291325696,0.9146089115740103
Chamberí,2012,65-84,9429,16321,25750,534,26284,9927,18458,28385,611,28996,0.9498337866424902,0.8842236428648824,0.9071692795490576,0.8739770867430442,0.9064698579114361
Chamberí,2013,65-84,9498,16215,25713,524,26237,9927,18458,28385,611,28996,0.9567845270474463,0.8784808755011377,0.9058657741765017,0.8576104746317512,0.9048489446820251
Chamberí,2014,65-84,9554,16112,25666,503,26169,9927,18458,28385,611,28996,0.9624257076659615,0.8729006392891971,0.9042099700546063,0.823240589198036,0.9025037936267072
Chamberí,2015,65-84,9588,16013,25601,508,26109,9927,18458,28385,611,28996,0.9658507101843458,0.8675371112796619,0.9019200281838999,0.8314238952536824,0.9004345426955442
Chamberí,2016,65-84,9632,15843,25475,532,26007,9927,18458,28385,611,28996,0.9702830663846076,0.8583270126774298,0.897481063942223,0.8707037643207856,0.8969168161125672
Chamberí,2017,65-84,9679,15791,25470,577,26047,9927,18458,28385,611,28996,0.9750176286894329,0.8555098060461589,0.8973049145675532,0.9443535188216039,0.8982963167333425
Chamberí,2004,85-100,1607,4801,6408,112,6520,1607,4801,6408,112,6520,1.0,1.0,1.0,1.0,1.0
Chamberí,2005,85-100,1594,4705,6299,113,6412,1607,4801,6408,112,6520,0.9919103920348475,0.9800041657987919,0.9829900124843945,1.0089285714285714,0.9834355828220859
Chamberí,2006,85-100,1532,4738,6270,115,6385,1607,4801,6408,112,6520,0.9533291848164281,0.9868777338054572,0.9784644194756554,1.0267857142857142,0.9792944785276073
Chamberí,2007,85-100,1645,5070,6715,97,6812,1607,4801,6408,112,6520,1.0236465463596764,1.0560299937513018,1.0479088639201,0.8660714285714286,1.0447852760736196
Chamberí,2008,85-100,1624,4995,6619,83,6702,1607,4801,6408,112,6520,1.0105787181082764,1.040408248281608,1.0329275905118602,0.7410714285714286,1.0279141104294478
Chamberí,2009,85-100,1638,5090,6728,83,6811,1607,4801,6408,112,6520,1.0192906036092098,1.0601957925432202,1.0499375780274656,0.7410714285714286,1.0446319018404908
Chamberí,2010,85-100,1673,5202,6875,86,6961,1607,4801,6408,112,6520,1.0410703173615432,1.083524265777963,1.0728776529338326,0.7678571428571429,1.067638036809816
Chamberí,2011,85-100,1745,5310,7055,87,7142,1607,4801,6408,112,6520,1.0858742999377722,1.106019579254322,1.1009675405742823,0.7767857142857143,1.095398773006135
Chamberí,2012,85-100,1762,5333,7095,65,7160,1607,4801,6408,112,6520,1.0964530180460486,1.1108102478650281,1.1072097378277153,0.5803571428571429,1.098159509202454
Chamberí,2013,85-100,1807,5367,7174,69,7243,1607,4801,6408,112,6520,1.1244555071561917,1.1178921058112894,1.119538077403246,0.6160714285714286,1.1108895705521473
Chamberí,2014,85-100,1883,5426,7309,71,7380,1607,4801,6408,112,6520,1.1717485998755446,1.1301812122474484,1.140605493133583,0.6339285714285714,1.1319018404907975
Chamberí,2015,85-100,1913,5532,7445,67,7512,1607,4801,6408,112,6520,1.1904169259489732,1.1522599458446157,1.161828963795256,0.5982142857142857,1.1521472392638037
Chamberí,2016,85-100,1947,5521,7468,57,7525,1607,4801,6408,112,6520,1.2115743621655257,1.1499687565090606,1.16541822721598,0.5089285714285714,1.1541411042944785
Chamberí,2017,85-100,1954,5548,7502,72,7574,1607,4801,6408,112,6520,1.2159303049159926,1.1555925848781503,1.1707240948813982,0.6428571428571429,1.1616564417177915
Chamberí,2004,Total,56746,74908,131654,21352,153006,56746,74908,131654,21352,153006,1.0,1.0,1.0,1.0,1.0
Chamberí,2005,Total,56332,73902,130234,22790,153024,56746,74908,131654,21352,153006,0.9927043315828429,0.9865701927697976,0.989214152247558,1.0673473210940427,1.0001176424453944
Chamberí,2006,Total,55574,72704,128278,24491,152769,56746,74908,131654,21352,153006,0.9793465618722025,0.9705772414161371,0.9743570267519407,1.1470119895091795,0.9984510411356418
Chamberí,2007,Total,54101,71061,125162,20293,145455,56746,74908,131654,21352,153006,0.953388785112607,0.9486436695680034,0.9506889270360187,0.9504027725739977,0.9506489941570919
Chamberí,2008,Total,54418,71203,125621,20875,146496,56746,74908,131654,21352,153006,0.9589750819441017,0.9505393282426443,0.9541753383869841,0.9776601723491944,0.9574526489157288
Chamberí,2009,Total,54233,71142,125375,21310,146685,56746,74908,131654,21352,153006,0.9557149402601064,0.9497249959950873,0.9523068041988849,0.9980329711502436,0.9586878945923689
Chamberí,2010,Total,54077,70864,124941,20915,145856,56746,74908,131654,21352,153006,0.9529658478130617,0.9460137768996636,0.949010284533702,0.9795335331584863,0.9532698064128204
Chamberí,2011,Total,54083,70612,124695,20401,145096,56746,74908,131654,21352,153006,0.9530715821379481,0.9426496502376248,0.9471417503456029,0.9554608467590858,0.9483026809406168
Chamberí,2012,Total,53961,70185,124146,17922,142068,56746,74908,131654,21352,153006,0.9509216508652593,0.9369493245047258,0.9429717289258207,0.8393593106032222,0.9285126073487314
Chamberí,2013,Total,54142,70190,124332,17454,141786,56746,74908,131654,21352,153006,0.9541113029993303,0.9370160730496075,0.944384523068042,0.8174409891345074,0.9266695423708874
Chamberí,2014,Total,53796,69337,123133,16043,139176,56746,74908,131654,21352,153006,0.948013956930885,0.9256287712927859,0.9352773178179167,0.7513581865867366,0.9096113877887142
Chamberí,2015,Total,53702,69374,123076,14691,137767,56746,74908,131654,21352,153006,0.9463574525076658,0.9261227105249106,0.9348443647743327,0.6880385912326714,0.9004025985909049
Chamberí,2016,Total,54166,69481,123647,14406,138053,56746,74908,131654,21352,153006,0.9545342402988757,0.9275511293853794,0.9391814908776034,0.6746908954664669,0.9022718063343921
Chamberí,2017,Total,54268,69286,123554,14389,137943,56746,74908,131654,21352,153006,0.9563317238219434,0.9249479361349923,0.9384750938064927,0.6738947171225178,0.9015528802792048
Ciudad Lineal,2004,0-24,13862,13364,27226,7740,34966,13862,13364,27226,7740,34966,1.0,1.0,1.0,1.0,1.0
Ciudad Lineal,2005,0-24,13218,12852,26070,7777,33847,13862,13364,27226,7740,34966,0.9535420574231712,0.9616881173301407,0.9575405862043634,1.0047803617571058,0.9679974832694618
Ciudad Lineal,2006,0-24,12747,12360,25107,8058,33165,13862,13364,27226,7740,34966,0.9195642764391863,0.9248727925770728,0.9221699845735694,1.0410852713178294,0.9484928215981239
Ciudad Lineal,2007,0-24,12179,11847,24026,7257,31283,13862,13364,27226,7740,34966,0.8785889482037224,0.8864860820113738,0.88246529053111,0.9375968992248062,0.8946691071326431
Ciudad Lineal,2008,0-24,12161,11721,23882,8126,32008,13862,13364,27226,7740,34966,0.8772904342807676,0.8770577671355881,0.8771762286050099,1.0498708010335918,0.9154035348624378
Ciudad Lineal,2009,0-24,12035,11588,23623,8284,31907,13862,13364,27226,7740,34966,0.8682008368200836,0.8671056569889255,0.8676632630573716,1.0702842377260982,0.9125150145855975
Ciudad Lineal,2010,0-24,11972,11522,23494,7795,31289,13862,13364,27226,7740,34966,0.8636560380897418,0.862167015863514,0.862925145081907,1.0071059431524547,0.8948407023966138
Ciudad Lineal,2011,0-24,12043,11499,23542,6907,30449,13862,13364,27226,7740,34966,0.8687779541191747,0.8604459742592039,0.8646881657239404,0.8923772609819122,0.8708173654407139
Ciudad Lineal,2012,0-24,12152,11678,23830,5757,29587,13862,13364,27226,7740,34966,0.8766411773192901,0.8738401676144867,0.8752662895761405,0.743798449612403,0.8461648458502545
Ciudad Lineal,2013,0-24,12327,11677,24004,4968,28972,13862,13364,27226,7740,34966,0.8892656182369066,0.8737653397186471,0.8816572394035114,0.641860465116279,0.8285763312932563
Ciudad Lineal,2014,0-24,12284,11741,24025,4313,28338,13862,13364,27226,7740,34966,0.8861636127542923,0.8785543250523795,0.8824285609344009,0.557235142118863,0.8104444317336842
Ciudad Lineal,2015,0-24,12416,11851,24267,3908,28175,13862,13364,27226,7740,34966,0.8956860481892944,0.8867853935947321,0.8913171233379857,0.5049095607235142,0.8057827603958131
Ciudad Lineal,2016,0-24,12548,11985,24533,3880,28413,13862,13364,27226,7740,34966,0.9052084836242966,0.8968123316372344,0.9010871960625872,0.5012919896640827,0.8125893725333181
Ciudad Lineal,2017,0-24,12567,12107,24674,3829,28503,13862,13364,27226,7740,34966,0.9065791372096379,0.9059413349296618,0.9062660691985602,0.494702842377261,0.8151633014928787
Ciudad Lineal,2004,25-39,23318,23603,46921,15473,62394,23318,23603,46921,15473,62394,1.0,1.0,1.0,1.0,1.0
Ciudad Lineal,2005,25-39,22034,22173,44207,16949,61156,23318,23603,46921,15473,62394,0.9449352431597907,0.9394144812100157,0.9421580955222608,1.0953919731144575,0.9801583485591563
Ciudad Lineal,2006,25-39,20757,20859,41616,18595,60211,23318,23603,46921,15473,62394,0.8901706835920747,0.8837435919162818,0.8869376185503293,1.2017708266011762,0.9650126614738597
Ciudad Lineal,2007,25-39,19092,19230,38322,17496,55818,23318,23603,46921,15473,62394,0.8187666180632988,0.8147269414904885,0.8167345111996761,1.1307438764299103,0.8946052505048563
Ciudad Lineal,2008,25-39,18793,19001,37794,18582,56376,23318,23603,46921,15473,62394,0.8059439059953684,0.8050247849849596,0.805481554101575,1.2009306533962385,0.9035484181171266
Ciudad Lineal,2009,25-39,18262,18475,36737,19235,55972,23318,23603,46921,15473,62394,0.7831717986105154,0.7827394822692031,0.7829543274866264,1.2431331997673367,0.8970734365483861
Ciudad Lineal,2010,25-39,17797,18025,35822,19002,54824,23318,23603,46921,15473,62394,0.7632301226520285,0.7636741092234038,0.7634534643336672,1.2280747107865313,0.8786742314966183
Ciudad Lineal,2011,25-39,17256,17530,34786,18172,52958,23318,23603,46921,15473,62394,0.7400291620207565,0.7427021988730246,0.7413737985123932,1.174432883086667,0.8487675096964452
Ciudad Lineal,2012,25-39,16872,17056,33928,16343,50271,23318,23603,46921,15473,62394,0.723561197358264,0.7226200059314494,0.723087743227979,1.0562269760227494,0.80570247139148
Ciudad Lineal,2013,25-39,16528,16817,33345,14507,47852,23318,23603,46921,15473,62394,0.7088086456814479,0.7124941744693472,0.7106626030988257,0.9375686680023266,0.7669327178895406
Ciudad Lineal,2014,25-39,16117,16394,32511,12416,44927,23318,23603,46921,15473,62394,0.6911827772536238,0.6945727238062958,0.6928880458643252,0.8024300394235119,0.7200532102445748
Ciudad Lineal,2015,25-39,15980,16208,32188,10907,43095,23318,23603,46921,15473,62394,0.6853074877776825,0.6866923696140321,0.6860041346092368,0.7049053189426744,0.6906914126358303
Ciudad Lineal,2016,25-39,15702,15937,31639,10802,42441,23318,23603,46921,15473,62394,0.6733853675272322,0.6752107782908953,0.6743036167174613,0.6981193045951012,0.6802096355418791
Ciudad Lineal,2017,25-39,15290,15757,31047,10757,41804,23318,23603,46921,15473,62394,0.6557166137747663,0.6675846290725755,0.6616866648195904,0.6952110127318555,0.670000320543642
Ciudad Lineal,2004,40-64,28721,34742,63463,7330,70793,28721,34742,63463,7330,70793,1.0,1.0,1.0,1.0,1.0
Ciudad Lineal,2005,40-64,28994,35097,64091,8314,72405,28721,34742,63463,7330,70793,1.0095052400682427,1.0102181797248286,1.0098955296787104,1.1342428376534788,1.0227706129137062
Ciudad Lineal,2006,40-64,28801,34823,63624,9689,73313,28721,34742,63463,7330,70793,1.0027854183350162,1.0023314719935525,1.0025369112711344,1.3218281036834925,1.0355967397906574
Ciudad Lineal,2007,40-64,28747,34721,63468,9325,72793,28721,34742,63463,7330,70793,1.0009052609588802,0.9993955442979678,1.000078786064321,1.2721691678035472,1.028251380786236
Ciudad Lineal,2008,40-64,28834,34917,63751,9818,73569,28721,34742,63463,7330,70793,1.0039344033982103,1.0050371308502677,1.0045380773048862,1.3394270122783083,1.0392129165312955
Ciudad Lineal,2009,40-64,28987,35174,64161,10439,74600,28721,34742,63463,7330,70793,1.0092615159639289,1.0124345172989466,1.0109985345792036,1.4241473396998636,1.0537765033266
Ciudad Lineal,2010,40-64,29278,35327,64605,10851,75456,28721,34742,63463,7330,70793,1.0193934751575502,1.0168384088423235,1.0179947370909033,1.4803547066848568,1.0658680943031091
Ciudad Lineal,2011,40-64,29399,35352,64751,10878,75629,28721,34742,63463,7330,70793,1.0236064203892623,1.0175579989637902,1.020295290169075,1.4840381991814462,1.0683118387411186
Ciudad Lineal,2012,40-64,29664,35737,65401,10068,75469,28721,34742,63463,7330,70793,1.0328331186240034,1.0286396868343792,1.0305374785307975,1.3735334242837653,1.0660517282782196
Ciudad Lineal,2013,40-64,29872,36074,65946,9329,75275,28721,34742,63463,7330,70793,1.0400752062950454,1.0383397616717518,1.0391251595417803,1.2727148703956344,1.0633113443419546
Ciudad Lineal,2014,40-64,29843,36095,65938,8628,74566,28721,34742,63463,7330,70793,1.039065492148602,1.038944217373784,1.0389991018388667,1.177080491132333,1.053296229853234
Ciudad Lineal,2015,40-64,30041,36338,66379,8025,74404,28721,34742,63463,7330,70793,1.0459594025277672,1.0459386333544414,1.045948032711974,1.0948158253751705,1.051007868009549
Ciudad Lineal,2016,40-64,30360,36686,67046,8496,75542,28721,34742,63463,7330,70793,1.0570662581386443,1.0559553278452594,1.0564580936923877,1.1590723055934515,1.0670829036769172
Ciudad Lineal,2017,40-64,30534,36912,67446,8787,76233,28721,34742,63463,7330,70793,1.0631245430173044,1.0624604225433194,1.0627609788380632,1.1987721691678035,1.0768437557385617
Ciudad Lineal,2004,65-84,17064,24746,41810,734,42544,17064,24746,41810,734,42544,1.0,1.0,1.0,1.0,1.0
Ciudad Lineal,2005,65-84,16778,24542,41320,842,42162,17064,24746,41810,734,42544,0.9832395686826066,0.9917562434332822,0.988280315713944,1.1471389645776566,0.9910210605490786
Ciudad Lineal,2006,65-84,16883,24835,41718,954,42672,17064,24746,41810,734,42544,0.9893928738865447,1.0035965408550878,0.9977995694809854,1.2997275204359673,1.0030086498683715
Ciudad Lineal,2007,65-84,16754,24713,41467,731,42198,17064,24746,41810,734,42544,0.9818330989217066,0.9986664511436192,0.9917962209997608,0.9959128065395095,0.9918672433245581
Ciudad Lineal,2008,65-84,16527,24503,41030,693,41723,17064,24746,41810,734,42544,0.9685302390998594,0.9901802311484684,0.9813441760344416,0.944141689373297,0.980702331703648
Ciudad Lineal,2009,65-84,16516,24590,41106,727,41833,17064,24746,41810,734,42544,0.9678856071261135,0.9936959508607451,0.9831619229849319,0.9904632152588556,0.9832878901842798
Ciudad Lineal,2010,65-84,16473,24713,41186,757,41943,17064,24746,41810,734,42544,0.965365682137834,0.9986664511436192,0.9850753408275532,1.0313351498637602,0.9858734486649117
Ciudad Lineal,2011,65-84,16415,24693,41108,766,41874,17064,24746,41810,734,42544,0.961966713548992,0.9978582397155096,0.9832097584309973,1.0435967302452316,0.9842515983452426
Ciudad Lineal,2012,65-84,16337,24671,41008,697,41705,17064,24746,41810,734,42544,0.9573956868260666,0.996969207144589,0.9808179861277206,0.9495912806539509,0.9802792403159082
Ciudad Lineal,2013,65-84,16214,24565,40779,702,41481,17064,24746,41810,734,42544,0.9501875293014533,0.9926856865756082,0.9753408275532169,0.9564032697547684,0.975014103046258
Ciudad Lineal,2014,65-84,16125,24332,40457,707,41164,17064,24746,41810,734,42544,0.944971870604782,0.9832700234381314,0.9676393207366659,0.9632152588555858,0.967562993606619
Ciudad Lineal,2015,65-84,15987,24145,40132,682,40814,17064,24746,41810,734,42544,0.9368846694796061,0.9757132465853067,0.9598660607510165,0.9291553133514986,0.9593362166227906
Ciudad Lineal,2016,65-84,15750,23772,39522,819,40341,17064,24746,41810,734,42544,0.9229957805907173,0.9606401034510628,0.9452762497010284,1.1158038147138964,0.9482183151560737
Ciudad Lineal,2017,65-84,15555,23430,38985,930,39915,17064,24746,41810,734,42544,0.9115682137834037,0.9468196880303887,0.9324324324324325,1.2670299727520435,0.9382051523128996
Ciudad Lineal,2004,85-100,1374,3484,4858,62,4920,1374,3484,4858,62,4920,1.0,1.0,1.0,1.0,1.0
Ciudad Lineal,2005,85-100,1383,3549,4932,74,5006,1374,3484,4858,62,4920,1.0065502183406114,1.0186567164179106,1.015232606010704,1.1935483870967742,1.017479674796748
Ciudad Lineal,2006,85-100,1419,3684,5103,79,5182,1374,3484,4858,62,4920,1.0327510917030567,1.0574052812858783,1.0504322766570606,1.2741935483870968,1.0532520325203252
Ciudad Lineal,2007,85-100,1681,4193,5874,62,5936,1374,3484,4858,62,4920,1.2234352256186318,1.2035017221584385,1.2091395636064224,1.0,1.2065040650406504
Ciudad Lineal,2008,85-100,1663,4183,5846,58,5904,1374,3484,4858,62,4920,1.210334788937409,1.2006314580941446,1.2033758748456156,0.9354838709677419,1.2
Ciudad Lineal,2009,85-100,1788,4370,6158,68,6226,1374,3484,4858,62,4920,1.3013100436681222,1.254305396096441,1.2675998353231783,1.096774193548387,1.2654471544715447
Ciudad Lineal,2010,85-100,1952,4583,6535,64,6599,1374,3484,4858,62,4920,1.420669577874818,1.3154420206659012,1.3452037875669,1.032258064516129,1.341260162601626
Ciudad Lineal,2011,85-100,2089,4830,6919,69,6988,1374,3484,4858,62,4920,1.5203784570596797,1.386337543053961,1.4242486620008235,1.1129032258064515,1.4203252032520326
Ciudad Lineal,2012,85-100,2220,5021,7241,67,7308,1374,3484,4858,62,4920,1.6157205240174672,1.4411595866819746,1.4905310827501028,1.0806451612903225,1.4853658536585366
Ciudad Lineal,2013,85-100,2399,5228,7627,67,7694,1374,3484,4858,62,4920,1.7459970887918486,1.5005740528128588,1.5699876492383698,1.0806451612903225,1.563821138211382
Ciudad Lineal,2014,85-100,2612,5581,8193,60,8253,1374,3484,4858,62,4920,1.901018922852984,1.601894374282434,1.686496500617538,0.967741935483871,1.677439024390244
Ciudad Lineal,2015,85-100,2791,5830,8621,60,8681,1374,3484,4858,62,4920,2.0312954876273652,1.6733639494833525,1.7745986002470153,0.967741935483871,1.764430894308943
Ciudad Lineal,2016,85-100,2948,6234,9182,64,9246,1374,3484,4858,62,4920,2.1455604075691412,1.7893226176808266,1.8900782214903253,1.032258064516129,1.8792682926829267
Ciudad Lineal,2017,85-100,3121,6519,9640,69,9709,1374,3484,4858,62,4920,2.2714701601164484,1.8711251435132032,1.9843557019349527,1.1129032258064515,1.9733739837398374
Ciudad Lineal,2004,Total,92559,107681,200240,34836,235076,92559,107681,200240,34836,235076,1.0,1.0,1.0,1.0,1.0
Ciudad Lineal,2005,Total,90705,105947,196652,37569,234221,92559,107681,200240,34836,235076,0.979969532946553,0.9838968806010345,0.9820815021973631,1.0784533241474337,0.9963628783882659
Ciudad Lineal,2006,Total,88971,104366,193337,41055,234392,92559,107681,200240,34836,235076,0.9612355362525524,0.9692146246784484,0.9655263683579705,1.1785222183947641,0.9970903027106127
Ciudad Lineal,2007,Total,86553,102259,188812,37859,226671,92559,107681,200240,34836,235076,0.9351116585097073,0.9496475701377216,0.9429284858170196,1.0867780456998508,0.9642456056764621
Ciudad Lineal,2008,Total,86294,102134,188428,40437,228865,92559,107681,200240,34836,235076,0.9323134433172355,0.9484867339642091,0.9410107870555333,1.1607819497071994,0.9735787575082101
Ciudad Lineal,2009,Total,86058,102273,188331,41923,230254,92559,107681,200240,34836,235076,0.9297637182769909,0.949777583789155,0.9405263683579704,1.20343897117924,0.9794874848985009
Ciudad Lineal,2010,Total,85983,102260,188243,41494,229737,92559,107681,200240,34836,235076,0.9289534243023368,0.9496568568271097,0.9400868957251298,1.1911241244689401,0.9772881961578384
Ciudad Lineal,2011,Total,85713,101927,187640,39689,227329,92559,107681,200240,34836,235076,0.9260363659935825,0.9465643892608724,0.9370755093887335,1.139309909289241,0.9670447004373054
Ciudad Lineal,2012,Total,85619,102034,187653,35670,223323,92559,107681,200240,34836,235076,0.9250207975453495,0.9475580650253991,0.9371404314822214,1.023940750947296,0.9500034031547244
Ciudad Lineal,2013,Total,85520,102112,187632,32198,219830,92559,107681,200240,34836,235076,0.9239512094988062,0.9482824267976709,0.9370355573312026,0.9242737398093925,0.9351443788391839
Ciudad Lineal,2014,Total,84892,101581,186473,28501,214974,92559,107681,200240,34836,235076,0.9171663479510367,0.9433511947325898,0.9312475029964044,0.8181478929842692,0.9144872296618966
Ciudad Lineal,2015,Total,84888,101675,186563,25701,212264,92559,107681,200240,34836,235076,0.9171231322723884,0.9442241435350712,0.9316969636436276,0.7377712710988632,0.9029590430328915
Ciudad Lineal,2016,Total,84957,101883,186840,26208,213048,92559,107681,200240,34836,235076,0.9178686027290701,0.946155774927796,0.9330803036356372,0.7523251808473992,0.9062941346628325
Ciudad Lineal,2017,Total,84614,101947,186561,26572,213133,92559,107681,200240,34836,235076,0.9141628582849858,0.9467501230486344,0.9316869756292449,0.762774141692502,0.9066557198523031
Fuencarral - El Pardo,2004,0-24,16480,15851,32331,3764,36095,16480,15851,32331,3764,36095,1.0,1.0,1.0,1.0,1.0
Fuencarral - El Pardo,2005,0-24,15455,14964,30419,3909,34328,16480,15851,32331,3764,36095,0.9378033980582524,0.9440413854015519,0.9408617116699143,1.0385228480340063,0.9510458512259315
Fuencarral - El Pardo,2006,0-24,14898,14390,29288,4164,33452,16480,15851,32331,3764,36095,0.9040048543689321,0.9078291590435935,0.9058798057591785,1.106269925611052,0.9267765618506718
Fuencarral - El Pardo,2007,0-24,14282,13794,28076,3594,31670,16480,15851,32331,3764,36095,0.866626213592233,0.8702290076335878,0.8683925644118647,0.9548352816153028,0.8774068430530544
Fuencarral - El Pardo,2008,0-24,14238,13779,28017,4304,32321,16480,15851,32331,3764,36095,0.8639563106796116,0.8692826950981011,0.8665676904518883,1.1434643995749203,0.8954425820750797
Fuencarral - El Pardo,2009,0-24,14009,13644,27653,4483,32136,16480,15851,32331,3764,36095,0.8500606796116504,0.8607658822787206,0.8553091460208468,1.191020191285866,0.8903172184513091
Fuencarral - El Pardo,2010,0-24,13829,13405,27234,4262,31496,16480,15851,32331,3764,36095,0.8391383495145631,0.8456879692132988,0.8423494478983019,1.1323060573857597,0.8725862307798864
Fuencarral - El Pardo,2011,0-24,13731,13318,27049,3953,31002,16480,15851,32331,3764,36095,0.8331917475728156,0.8401993565074759,0.8366273854814265,1.050212539851222,0.8589001246710071
Fuencarral - El Pardo,2012,0-24,13818,13385,27203,3328,30531,16480,15851,32331,3764,36095,0.8384708737864077,0.8444262191659833,0.8413906158176363,0.8841657810839533,0.8458512259315695
Fuencarral - El Pardo,2013,0-24,13807,13436,27243,3051,30294,16480,15851,32331,3764,36095,0.8378033980582524,0.8476436817866381,0.8426278185023661,0.8105738575982997,0.8392852195594958
Fuencarral - El Pardo,2014,0-24,13898,13441,27339,2716,30055,16480,15851,32331,3764,36095,0.8433252427184466,0.847959119298467,0.8455971049457177,0.7215727948990436,0.8326638038509488
Fuencarral - El Pardo,2015,0-24,13974,13595,27569,2421,29990,16480,15851,32331,3764,36095,0.8479368932038835,0.8576745946627973,0.8527110203829142,0.6431987247608927,0.83086300041557
Fuencarral - El Pardo,2016,0-24,14263,13894,28157,2408,30565,16480,15851,32331,3764,36095,0.8654733009708738,0.876537757870166,0.8708978998484427,0.6397449521785334,0.8467931846516138
Fuencarral - El Pardo,2017,0-24,14717,14201,28918,2507,31425,16480,15851,32331,3764,36095,0.8930218446601942,0.8959056210964608,0.8944356809254276,0.6660467587672688,0.8706191993350879
Fuencarral - El Pardo,2004,25-39,22644,22411,45055,7309,52364,22644,22411,45055,7309,52364,1.0,1.0,1.0,1.0,1.0
Fuencarral - El Pardo,2005,25-39,22046,21667,43713,7960,51673,22644,22411,45055,7309,52364,0.9735912382971207,0.9668020168667172,0.9702141826656309,1.0890682719934328,0.9868039110839508
Fuencarral - El Pardo,2006,25-39,21918,21472,43390,8958,52348,22644,22411,45055,7309,52364,0.9679385267620562,0.958100932577752,0.963045167018089,1.225612258858941,0.9996944465663433
Fuencarral - El Pardo,2007,25-39,22537,21927,44464,8745,53209,22644,22411,45055,7309,52364,0.995274686451157,0.9784034625853375,0.9868826989235379,1.196470105349569,1.016137040714995
Fuencarral - El Pardo,2008,25-39,23399,23035,46434,10006,56440,22644,22411,45055,7309,52364,1.033342165695107,1.0278434697246888,1.0306070358450783,1.3689971268299357,1.0778397372240471
Fuencarral - El Pardo,2009,25-39,23788,23594,47382,11074,58456,22644,22411,45055,7309,52364,1.0505211093446387,1.0527865780197225,1.0516479857951393,1.5151183472431249,1.1163394698647926
Fuencarral - El Pardo,2010,25-39,23878,23991,47869,11347,59216,22644,22411,45055,7309,52364,1.054495672142731,1.0705010932131542,1.0624569970036621,1.5524695580790806,1.1308532579634865
Fuencarral - El Pardo,2011,25-39,23807,24085,47892,11296,59188,22644,22411,45055,7309,52364,1.0513601837131248,1.0746954620498863,1.0629674841859948,1.5454918593514844,1.1303185394545872
Fuencarral - El Pardo,2012,25-39,23418,23897,47315,10337,57652,22644,22411,45055,7309,52364,1.034181240063593,1.0663067243764224,1.0501609144379092,1.4142837597482556,1.100985409823543
Fuencarral - El Pardo,2013,25-39,23026,23480,46506,9416,55922,22644,22411,45055,7309,52364,1.016869810987458,1.0476997902815581,1.0322050826767284,1.2882747297851964,1.067947444809411
Fuencarral - El Pardo,2014,25-39,22119,22703,44822,8122,52944,22644,22411,45055,7309,52364,0.9768150503444621,1.013029315960912,0.9948285428920208,1.1112327267752087,1.0110763119700559
Fuencarral - El Pardo,2015,25-39,21478,22058,43536,7159,50695,22644,22411,45055,7309,52364,0.9485073308602721,0.9842488063897193,0.9662856508711575,0.9794773566835409,0.9681269574516843
Fuencarral - El Pardo,2016,25-39,20822,21268,42090,6995,49085,22644,22411,45055,7309,52364,0.9195371842430666,0.9489982597831422,0.9341915436688492,0.9570392666575455,0.9373806431899778
Fuencarral - El Pardo,2017,25-39,20230,20519,40749,7124,47873,22644,22411,45055,7309,52364,0.8933933933933934,0.9155771719245014,0.9044279214293641,0.9746887399097004,0.914234970590482
Fuencarral - El Pardo,2004,40-64,30680,35787,66467,4300,70767,30680,35787,66467,4300,70767,1.0,1.0,1.0,1.0,1.0
Fuencarral - El Pardo,2005,40-64,30733,35915,66648,4880,71528,30680,35787,66467,4300,70767,1.0017275097783573,1.003576717802554,1.002723155851776,1.1348837209302325,1.010753599841734
Fuencarral - El Pardo,2006,40-64,30622,35940,66562,5571,72133,30680,35787,66467,4300,70767,0.998109517601043,1.0042752954983654,1.0014292806956835,1.2955813953488373,1.0193027823703138
Fuencarral - El Pardo,2007,40-64,30948,36386,67334,5162,72496,30680,35787,66467,4300,70767,1.008735332464146,1.0167379215916394,1.013044066980607,1.2004651162790698,1.0244322918874618
Fuencarral - El Pardo,2008,40-64,31397,36797,68194,5669,73863,30680,35787,66467,4300,70767,1.0233702737940027,1.0282225389107778,1.0259828185415318,1.3183720930232559,1.043749205137988
Fuencarral - El Pardo,2009,40-64,31631,37188,68819,6200,75019,30680,35787,66467,4300,70767,1.0309973924380704,1.0391482940732668,1.0353859810131343,1.441860465116279,1.060084502663671
Fuencarral - El Pardo,2010,40-64,31880,37429,69309,6512,75821,30680,35787,66467,4300,70767,1.0391134289439374,1.045882583060888,1.0427580603908706,1.5144186046511627,1.0714174685941187
Fuencarral - El Pardo,2011,40-64,32105,37459,69564,6610,76174,30680,35787,66467,4300,70767,1.0464471968709257,1.0467208762958615,1.0465945506792844,1.5372093023255815,1.0764056693091413
Fuencarral - El Pardo,2012,40-64,32479,37705,70184,6192,76376,30680,35787,66467,4300,70767,1.058637548891786,1.0535948808226452,1.055922487851114,1.44,1.079260107112072
Fuencarral - El Pardo,2013,40-64,32922,38112,71034,5815,76849,30680,35787,66467,4300,70767,1.073076923076923,1.0649677257104535,1.0687107888124934,1.3523255813953488,1.085944013452598
Fuencarral - El Pardo,2014,40-64,33436,38122,71558,5455,77013,30680,35787,66467,4300,70767,1.0898305084745763,1.065247156788778,1.076594400228685,1.2686046511627906,1.0882614778074526
Fuencarral - El Pardo,2015,40-64,34071,38709,72780,5100,77880,30680,35787,66467,4300,70767,1.110528031290743,1.081649761086428,1.094979463493162,1.186046511627907,1.1005129509517149
Fuencarral - El Pardo,2016,40-64,34830,39498,74328,5317,79645,30680,35787,66467,4300,70767,1.1352672750977835,1.1036968731662335,1.118269216302827,1.2365116279069768,1.1254539545268274
Fuencarral - El Pardo,2017,40-64,35608,40247,75855,5649,81504,30680,35787,66467,4300,70767,1.160625814863103,1.1246262609327409,1.141243022853446,1.313720930232558,1.151723260841918
Fuencarral - El Pardo,2004,65-84,12662,16728,29390,571,29961,12662,16728,29390,571,29961,1.0,1.0,1.0,1.0,1.0
Fuencarral - El Pardo,2005,65-84,12662,16878,29540,624,30164,12662,16728,29390,571,29961,1.0,1.0089670014347203,1.005103776794828,1.0928196147110332,1.0067754747838857
Fuencarral - El Pardo,2006,65-84,13214,17390,30604,703,31307,12662,16728,29390,571,29961,1.043595008687411,1.0395743663318986,1.041306566859476,1.2311733800350262,1.0449250692567005
Fuencarral - El Pardo,2007,65-84,13834,17984,31818,569,32387,12662,16728,29390,571,29961,1.0925604169957353,1.0750836920133908,1.082613133718952,0.9964973730297724,1.0809719301758953
Fuencarral - El Pardo,2008,65-84,13962,18195,32157,570,32727,12662,16728,29390,571,29961,1.1026694045174539,1.0876972740315638,1.0941476692752636,0.9982486865148862,1.092320016020827
Fuencarral - El Pardo,2009,65-84,14437,18807,33244,595,33839,12662,16728,29390,571,29961,1.140183225398831,1.1242826398852224,1.131133038448452,1.042031523642732,1.1294349320783685
Fuencarral - El Pardo,2010,65-84,14987,19398,34385,615,35000,12662,16728,29390,571,29961,1.1836202811562155,1.1596126255380201,1.169955767267778,1.0770577933450087,1.1681853075665032
Fuencarral - El Pardo,2011,65-84,15615,20052,35667,617,36284,12662,16728,29390,571,29961,1.233217501184647,1.1987087517934003,1.2135760462742429,1.0805604203152364,1.2110410199926571
Fuencarral - El Pardo,2012,65-84,16140,20649,36789,579,37368,12662,16728,29390,571,29961,1.2746801453166956,1.2343974175035868,1.2517522966995576,1.0140105078809107,1.2472213878041454
Fuencarral - El Pardo,2013,65-84,16637,21291,37928,627,38555,12662,16728,29390,571,29961,1.3139314484283684,1.2727761836441893,1.2905069751616196,1.0980735551663747,1.2868395580921865
Fuencarral - El Pardo,2014,65-84,17114,21929,39043,634,39677,12662,16728,29390,571,29961,1.3516032222397725,1.3109158297465329,1.328445049336509,1.1103327495621715,1.3242882413804613
Fuencarral - El Pardo,2015,65-84,17533,22579,40112,617,40729,12662,16728,29390,571,29961,1.3846943610803981,1.3497728359636538,1.3648179652943178,1.0805604203152364,1.359400554053603
Fuencarral - El Pardo,2016,65-84,17890,23049,40939,675,41614,12662,16728,29390,571,29961,1.4128889590901912,1.3778694404591105,1.392956788023137,1.182136602451839,1.3889389539734989
Fuencarral - El Pardo,2017,65-84,18113,23455,41568,756,42324,12662,16728,29390,571,29961,1.430500710788185,1.4021401243424199,1.4143586253827833,1.3239929947460596,1.4126364273555623
Fuencarral - El Pardo,2004,85-100,1006,2797,3803,55,3858,1006,2797,3803,55,3858,1.0,1.0,1.0,1.0,1.0
Fuencarral - El Pardo,2005,85-100,1026,2836,3862,62,3924,1006,2797,3803,55,3858,1.0198807157057654,1.0139435109045405,1.015514067841178,1.1272727272727272,1.0171073094867806
Fuencarral - El Pardo,2006,85-100,1067,2929,3996,64,4060,1006,2797,3803,55,3858,1.0606361829025845,1.0471934215230605,1.0507494083618196,1.1636363636363636,1.0523587350959047
Fuencarral - El Pardo,2007,85-100,1239,3243,4482,42,4524,1006,2797,3803,55,3858,1.231610337972167,1.1594565606006435,1.1785432553247437,0.7636363636363637,1.1726283048211508
Fuencarral - El Pardo,2008,85-100,1276,3253,4529,43,4572,1006,2797,3803,55,3858,1.268389662027833,1.163031819806936,1.1909019195372075,0.7818181818181819,1.1850699844479005
Fuencarral - El Pardo,2009,85-100,1350,3412,4762,42,4804,1006,2797,3803,55,3858,1.341948310139165,1.219878441186986,1.252169339994741,0.7636363636363637,1.2452047693105235
Fuencarral - El Pardo,2010,85-100,1476,3600,5076,56,5132,1006,2797,3803,55,3858,1.4671968190854872,1.2870933142652843,1.334735734946095,1.018181818181818,1.330222913426646
Fuencarral - El Pardo,2011,85-100,1575,3813,5388,56,5444,1006,2797,3803,55,3858,1.565606361829026,1.3632463353593136,1.4167762292926638,1.018181818181818,1.4110938310005183
Fuencarral - El Pardo,2012,85-100,1705,3996,5701,60,5761,1006,2797,3803,55,3858,1.694831013916501,1.4286735788344656,1.499079673941625,1.0909090909090908,1.4932607568688439
Fuencarral - El Pardo,2013,85-100,1822,4142,5964,54,6018,1006,2797,3803,55,3858,1.8111332007952285,1.4808723632463354,1.568235603470944,0.9818181818181818,1.5598755832037325
Fuencarral - El Pardo,2014,85-100,1930,4393,6323,54,6377,1006,2797,3803,55,3858,1.9184890656063618,1.570611369324276,1.6626347620299764,0.9818181818181818,1.652928978745464
Fuencarral - El Pardo,2015,85-100,2009,4554,6563,46,6609,1006,2797,3803,55,3858,1.997017892644135,1.6281730425455845,1.7257428346042598,0.8363636363636363,1.713063763608087
Fuencarral - El Pardo,2016,85-100,2197,4681,6878,54,6932,1006,2797,3803,55,3858,2.18389662027833,1.6735788344654987,1.8085721798580068,0.9818181818181818,1.7967858994297563
Fuencarral - El Pardo,2017,85-100,2346,4838,7184,62,7246,1006,2797,3803,55,3858,2.332007952286282,1.7297104040042903,1.8890349723902182,1.1272727272727272,1.8781752203214102
Fuencarral - El Pardo,2004,Total,91473,101236,192709,17839,210548,91473,101236,192709,17839,210548,1.0,1.0,1.0,1.0,1.0
Fuencarral - El Pardo,2005,Total,89972,99912,189884,19283,209167,91473,101236,192709,17839,210548,0.9835907863522569,0.9869216484254613,0.9853405912541708,1.0809462413812434,0.9934409255846648
Fuencarral - El Pardo,2006,Total,89988,100059,190047,21330,211377,91473,101236,192709,17839,210548,0.983765701354498,0.9883737010549607,0.986186426165877,1.1956948259431583,1.0039373444535213
Fuencarral - El Pardo,2007,Total,91388,101508,192896,19758,212654,91473,101236,192709,17839,210548,0.9990707640505941,1.0026867912600261,1.0009703750214054,1.1075732944671786,1.0100024697456162
Fuencarral - El Pardo,2008,Total,93803,104200,198003,22555,220558,91473,101236,192709,17839,210548,1.02547199720136,1.0292781224070489,1.027471472531122,1.2643645944279387,1.0475426031118795
Fuencarral - El Pardo,2009,Total,95592,106600,202192,24642,226834,91473,101236,192709,17839,210548,1.0450296808894428,1.0529851041131613,1.049208910844849,1.3813554571444588,1.0773505328951118
Fuencarral - El Pardo,2010,Total,97060,108416,205476,25032,230508,91473,101236,192709,17839,210548,1.0610781323450635,1.070923386937453,1.0662501491886731,1.4032176691518583,1.0948002355757358
Fuencarral - El Pardo,2011,Total,98431,109789,208220,24798,233018,91473,101236,192709,17839,210548,1.0760661615995977,1.0844857560551582,1.0804892350642679,1.3901003419474185,1.1067215076847086
Fuencarral - El Pardo,2012,Total,99780,111155,210935,22487,233422,91473,101236,192709,17839,210548,1.0908136827260504,1.0979789798095538,1.0945778349739763,1.2605527215651102,1.108640310048065
Fuencarral - El Pardo,2013,Total,101024,112532,213556,20942,234498,91473,101236,192709,17839,210548,1.1044133241502958,1.1115808605634359,1.1081786527873634,1.173944727843489,1.1137507836692822
Fuencarral - El Pardo,2014,Total,101542,112855,214397,18801,233198,91473,101236,192709,17839,210548,1.1100761973478512,1.114771425184717,1.1125427457980686,1.053926789618252,1.1075764196287783
Fuencarral - El Pardo,2015,Total,102408,114006,216414,16927,233341,91473,101236,192709,17839,210548,1.1195434718441508,1.1261408984946066,1.1230093041840288,0.9488760580750042,1.1082555996732337
Fuencarral - El Pardo,2016,Total,103710,115308,219018,17041,236059,91473,101236,192709,17839,210548,1.1337771801515202,1.1390019360701726,1.136521906086379,0.9552665508156287,1.121164770028687
Fuencarral - El Pardo,2017,Total,104980,116443,221423,17802,239225,91473,101236,192709,17839,210548,1.1476610584544074,1.150213362835355,1.1490018629124743,0.9979258927069903,1.136201721222714
Hortaleza,2004,0-24,11662,11105,22767,2927,25694,11662,11105,22767,2927,25694,1.0,1.0,1.0,1.0,1.0
Hortaleza,2005,0-24,11280,10651,21931,3210,25141,11662,11105,22767,2927,25694,0.9672440404733322,0.9591175146330482,0.9632801862344622,1.0966860266484455,0.978477465556161
Hortaleza,2006,0-24,11091,10518,21609,3557,25166,11662,11105,22767,2927,25694,0.951037557880295,0.9471409275101306,0.949136908683621,1.2152374444824052,0.9794504553592278
Hortaleza,2007,0-24,10835,10279,21114,3443,24557,11662,11105,22767,2927,25694,0.9290859200823186,0.9256190904997749,0.9273949136908683,1.176289716433208,0.955748423756519
Hortaleza,2008,0-24,10988,10414,21402,4018,25420,11662,11105,22767,2927,25694,0.9422054536100154,0.9377757766771725,0.9400448016866517,1.372736590365562,0.9893360317583871
Hortaleza,2009,0-24,11052,10483,21535,4260,25795,11662,11105,22767,2927,25694,0.9476933630595095,0.9439891940567312,0.94588659024026,1.4554151007857874,1.0039308788043901
Hortaleza,2010,0-24,11117,10545,21662,4132,25794,11662,11105,22767,2927,25694,0.953267021094152,0.9495722647456101,0.9514648394606229,1.4116843184147592,1.0038919592122675
Hortaleza,2011,0-24,11181,10620,21801,3884,25685,11662,11105,22767,2927,25694,0.958754930543646,0.9563259792886087,0.9575701673474766,1.3269559275708918,0.9996497236708959
Hortaleza,2012,0-24,11303,10722,22025,3225,25250,11662,11105,22767,2927,25694,0.9692162579317442,0.9655110310670869,0.9674089691219748,1.1018107277075504,0.9827197010975325
Hortaleza,2013,0-24,11364,10808,22172,2917,25089,11662,11105,22767,2927,25694,0.9744469216257932,0.9732552904097254,0.9738656827864892,0.9965835326272634,0.976453646765782
Hortaleza,2014,0-24,11496,10888,22384,2569,24953,11662,11105,22767,2927,25694,0.9857657348653748,0.9804592525889239,0.9831774058944964,0.87769046805603,0.9711605822370981
Hortaleza,2015,0-24,11670,11039,22709,2256,24965,11662,11105,22767,2927,25694,1.0006859886811867,0.9940567312021612,0.9974524531119603,0.7707550392893748,0.9716276173425703
Hortaleza,2016,0-24,11856,11353,23209,2257,25466,11662,11105,22767,2927,25694,1.016635225518779,1.0223322827555155,1.0194140642157508,0.7710966860266485,0.9911263329960303
Hortaleza,2017,0-24,12168,11542,23710,2301,26011,11662,11105,22767,2927,25694,1.0433887840850626,1.039351643403872,1.041419598541749,0.7861291424666894,1.0123375107028878
Hortaleza,2004,25-39,17160,16980,34140,5410,39550,17160,16980,34140,5410,39550,1.0,1.0,1.0,1.0,1.0
Hortaleza,2005,25-39,16795,16638,33433,6319,39752,17160,16980,34140,5410,39550,0.9787296037296037,0.9798586572438163,0.9792911540714704,1.1680221811460259,1.0051074589127686
Hortaleza,2006,25-39,16935,16767,33702,7411,41113,17160,16980,34140,5410,39550,0.9868881118881119,0.9874558303886926,0.9871704745166959,1.3698706099815157,1.039519595448799
Hortaleza,2007,25-39,16692,16723,33415,7489,40904,17160,16980,34140,5410,39550,0.9727272727272728,0.984864546525324,0.9787639132981839,1.3842883548983365,1.0342351453855878
Hortaleza,2008,25-39,17192,17346,34538,8439,42977,17160,16980,34140,5410,39550,1.0018648018648018,1.0215547703180212,1.0116578793204452,1.5598890942698707,1.0866498103666244
Hortaleza,2009,25-39,17024,17320,34344,9284,43628,17160,16980,34140,5410,39550,0.992074592074592,1.0200235571260305,1.00597539543058,1.7160813308687615,1.103109987357775
Hortaleza,2010,25-39,16813,17093,33906,9383,43289,17160,16980,34140,5410,39550,0.9797785547785548,1.0066548881036514,0.9931458699472759,1.734380776340111,1.0945385587863463
Hortaleza,2011,25-39,16375,16742,33117,9195,42312,17160,16980,34140,5410,39550,0.9542540792540792,0.9859835100117785,0.9700351493848858,1.6996303142329021,1.0698356510745892
Hortaleza,2012,25-39,15936,16228,32164,8190,40354,17160,16980,34140,5410,39550,0.9286713286713286,0.9557126030624263,0.9421206795547744,1.5138632162661738,1.0203286978508217
Hortaleza,2013,25-39,15417,15661,31078,7376,38454,17160,16980,34140,5410,39550,0.8984265734265734,0.9223203769140165,0.9103104862331576,1.3634011090573013,0.9722882427307206
Hortaleza,2014,25-39,14896,15154,30050,6459,36509,17160,16980,34140,5410,39550,0.8680652680652681,0.8924617196702003,0.880199179847686,1.1939001848428836,0.9231099873577749
Hortaleza,2015,25-39,14984,15229,30213,5692,35905,17160,16980,34140,5410,39550,0.8731934731934732,0.8968786808009422,0.8849736379613357,1.0521256931608134,0.9078381795195954
Hortaleza,2016,25-39,14957,15265,30222,5674,35896,17160,16980,34140,5410,39550,0.8716200466200467,0.8989988221436984,0.885237258347979,1.0487985212569315,0.9076106194690265
Hortaleza,2017,25-39,14627,14947,29574,5717,35291,17160,16980,34140,5410,39550,0.8523892773892774,0.8802709069493522,0.8662565905096661,1.056746765249538,0.8923135271807838
Hortaleza,2004,40-64,22639,24973,47612,3450,51062,22639,24973,47612,3450,51062,1.0,1.0,1.0,1.0,1.0
Hortaleza,2005,40-64,23051,25571,48622,4062,52684,22639,24973,47612,3450,51062,1.018198683687442,1.0239458615304529,1.0212131395446526,1.1773913043478261,1.0317653049234263
Hortaleza,2006,40-64,23214,25900,49114,4786,53900,22639,24973,47612,3450,51062,1.0253986483501922,1.0371200896968726,1.0315466689069983,1.3872463768115941,1.0555794915984489
Hortaleza,2007,40-64,23558,26533,50091,4861,54952,22639,24973,47612,3450,51062,1.0405936657979593,1.0624674648620511,1.052066705872469,1.4089855072463768,1.0761818965179586
Hortaleza,2008,40-64,23956,27078,51034,5278,56312,22639,24973,47612,3450,51062,1.0581739476125271,1.0842910343170624,1.0718726371502982,1.529855072463768,1.1028161842466022
Hortaleza,2009,40-64,24426,27496,51922,5911,57833,22639,24973,47612,3450,51062,1.0789345819161624,1.1010291114403556,1.0905233974628246,1.7133333333333334,1.132603501625475
Hortaleza,2010,40-64,24721,27883,52604,6246,58850,22639,24973,47612,3450,51062,1.0919651928088696,1.116525847915749,1.10484751743258,1.8104347826086957,1.1525204653166738
Hortaleza,2011,40-64,25190,28104,53294,6544,59838,22639,24973,47612,3450,51062,1.1126816555501569,1.1253754054378728,1.119339662270016,1.8968115942028985,1.1718694919901296
Hortaleza,2012,40-64,25579,28549,54128,5778,59906,22639,24973,47612,3450,51062,1.1298643933035912,1.14319465022224,1.1368562547256995,1.674782608695652,1.1732012063765618
Hortaleza,2013,40-64,25907,28885,54792,5542,60334,22639,24973,47612,3450,51062,1.1443526657537877,1.1566491811156048,1.150802318743174,1.606376811594203,1.1815831733970468
Hortaleza,2014,40-64,26111,29069,55180,5272,60452,22639,24973,47612,3450,51062,1.1533636644728125,1.1640171385095903,1.158951524825674,1.5281159420289856,1.1838940895382084
Hortaleza,2015,40-64,26875,29749,56624,4957,61581,22639,24973,47612,3450,51062,1.187110738106807,1.1912465462699715,1.1892800134419894,1.4368115942028985,1.2060044651600015
Hortaleza,2016,40-64,27713,30427,58140,5288,63428,22639,24973,47612,3450,51062,1.224126507354565,1.21839586753694,1.2211207258674284,1.5327536231884058,1.242176177979711
Hortaleza,2017,40-64,28461,31091,59552,5568,65120,22639,24973,47612,3450,51062,1.257166835990989,1.244984583350018,1.250777115013022,1.613913043478261,1.2753123653597587
Hortaleza,2004,65-84,8952,11573,20525,345,20870,8952,11573,20525,345,20870,1.0,1.0,1.0,1.0,1.0
Hortaleza,2005,65-84,9038,11662,20700,397,21097,8952,11573,20525,345,20870,1.0096067917783735,1.0076903136611077,1.0085261875761267,1.1507246376811595,1.0108768567321513
Hortaleza,2006,65-84,9429,12097,21526,477,22003,8952,11573,20525,345,20870,1.05328418230563,1.0452778017800053,1.0487697929354445,1.382608695652174,1.05428845232391
Hortaleza,2007,65-84,9898,12494,22392,477,22869,8952,11573,20525,345,20870,1.1056747095621091,1.0795817851896656,1.0909622411693056,1.382608695652174,1.0957834211787254
Hortaleza,2008,65-84,10052,12763,22815,525,23340,8952,11573,20525,345,20870,1.1228775692582662,1.102825542210317,1.1115712545676004,1.5217391304347827,1.118351701006229
Hortaleza,2009,65-84,10450,13212,23662,543,24205,8952,11573,20525,345,20870,1.1673369079535298,1.1416227425905123,1.1528380024360536,1.5739130434782609,1.159798754192621
Hortaleza,2010,65-84,10862,13727,24589,544,25133,8952,11573,20525,345,20870,1.2133601429848078,1.1861228722025403,1.1980024360535932,1.5768115942028986,1.204264494489698
Hortaleza,2011,65-84,11102,14217,25319,585,25904,8952,11573,20525,345,20870,1.2401697944593386,1.228462801347965,1.2335688185140072,1.6956521739130435,1.241207474844274
Hortaleza,2012,65-84,11283,14549,25832,562,26394,8952,11573,20525,345,20870,1.2603887399463807,1.257150263544457,1.2585627283800243,1.6289855072463768,1.2646861523718256
Hortaleza,2013,65-84,11535,14921,26456,579,27035,8952,11573,20525,345,20870,1.2885388739946382,1.289294046487514,1.2889646772228989,1.6782608695652175,1.2954000958313368
Hortaleza,2014,65-84,11865,15327,27192,547,27739,8952,11573,20525,345,20870,1.325402144772118,1.3243757020651516,1.3248233861144945,1.5855072463768116,1.3291327264015333
Hortaleza,2015,65-84,12003,15619,27622,566,28188,8952,11573,20525,345,20870,1.3408176943699732,1.349606843515078,1.3457734470158345,1.6405797101449275,1.3506468615237182
Hortaleza,2016,65-84,12092,15852,27944,609,28553,8952,11573,20525,345,20870,1.3507596067917784,1.369739911863821,1.3614616321559074,1.7652173913043478,1.368136080498323
Hortaleza,2017,65-84,12219,16084,28303,681,28984,8952,11573,20525,345,20870,1.364946380697051,1.3897865721938996,1.378952496954933,1.9739130434782608,1.3887877335888836
Hortaleza,2004,85-100,556,1620,2176,40,2216,556,1620,2176,40,2216,1.0,1.0,1.0,1.0,1.0
Hortaleza,2005,85-100,566,1661,2227,40,2267,556,1620,2176,40,2216,1.0179856115107915,1.0253086419753086,1.0234375,1.0,1.023014440433213
Hortaleza,2006,85-100,571,1712,2283,43,2326,556,1620,2176,40,2216,1.026978417266187,1.05679012345679,1.049172794117647,1.075,1.0496389891696751
Hortaleza,2007,85-100,711,1907,2618,29,2647,556,1620,2176,40,2216,1.2787769784172662,1.1771604938271605,1.203125,0.725,1.1944945848375452
Hortaleza,2008,85-100,735,1967,2702,30,2732,556,1620,2176,40,2216,1.3219424460431655,1.2141975308641975,1.2417279411764706,0.75,1.2328519855595668
Hortaleza,2009,85-100,789,2113,2902,39,2941,556,1620,2176,40,2216,1.419064748201439,1.304320987654321,1.333639705882353,0.975,1.3271660649819494
Hortaleza,2010,85-100,893,2255,3148,47,3195,556,1620,2176,40,2216,1.606115107913669,1.3919753086419753,1.4466911764705883,1.175,1.4417870036101084
Hortaleza,2011,85-100,987,2420,3407,47,3454,556,1620,2176,40,2216,1.775179856115108,1.4938271604938271,1.5657169117647058,1.175,1.5586642599277978
Hortaleza,2012,85-100,1072,2552,3624,49,3673,556,1620,2176,40,2216,1.9280575539568345,1.5753086419753086,1.6654411764705883,1.225,1.657490974729242
Hortaleza,2013,85-100,1167,2681,3848,51,3899,556,1620,2176,40,2216,2.0989208633093526,1.6549382716049383,1.7683823529411764,1.275,1.7594765342960288
Hortaleza,2014,85-100,1260,2759,4019,42,4061,556,1620,2176,40,2216,2.2661870503597124,1.7030864197530864,1.8469669117647058,1.05,1.8325812274368232
Hortaleza,2015,85-100,1373,2921,4294,55,4349,556,1620,2176,40,2216,2.4694244604316546,1.8030864197530865,1.9733455882352942,1.375,1.9625451263537905
Hortaleza,2016,85-100,1486,3128,4614,60,4674,556,1620,2176,40,2216,2.672661870503597,1.9308641975308642,2.120404411764706,1.5,2.1092057761732854
Hortaleza,2017,85-100,1656,3285,4941,62,5003,556,1620,2176,40,2216,2.9784172661870505,2.0277777777777777,2.2706801470588234,1.55,2.2576714801444044
Hortaleza,2004,Total,67352,72226,139578,13579,153157,67352,72226,139578,13579,153157,1.0,1.0,1.0,1.0,1.0
Hortaleza,2005,Total,67299,72474,139773,15566,155339,67352,72226,139578,13579,153157,0.9992130894405511,1.003433666546673,1.0013970683058935,1.1463288901981,1.0142468186240263
Hortaleza,2006,Total,68144,73653,141797,18007,159804,67352,72226,139578,13579,153157,1.0117591162845945,1.019757428072993,1.0158979208757828,1.326091759334266,1.0433999098963809
Hortaleza,2007,Total,68905,74802,143707,17839,161546,67352,72226,139578,13579,153157,1.0230579641287565,1.035665826710603,1.029582025820688,1.3137197142646735,1.0547738595036467
Hortaleza,2008,Total,70901,77188,148089,20147,168236,67352,72226,139578,13579,153157,1.0526933127449816,1.0687010217927062,1.0609766582126123,1.4836880477207453,1.098454527053938
Hortaleza,2009,Total,72185,78697,150882,22105,172987,67352,72226,139578,13579,153157,1.0717573346003089,1.0895937750948412,1.0809869750247174,1.6278812872818322,1.129474983187187
Hortaleza,2010,Total,73068,79783,152851,22460,175311,67352,72226,139578,13579,153157,1.0848675614681078,1.104629911666159,1.0950937826878162,1.6540245968038882,1.1446489549938952
Hortaleza,2011,Total,73786,80681,154467,22357,176824,67352,72226,139578,13579,153157,1.0955279724432831,1.1170631074682247,1.106671538494605,1.6464393548862213,1.1545277068628923
Hortaleza,2012,Total,74282,81270,155552,19650,175202,67352,72226,139578,13579,153157,1.1028922674902006,1.1252180655165729,1.1144449698376535,1.4470874143898667,1.1439372669874703
Hortaleza,2013,Total,74558,81648,156206,18293,174499,67352,72226,139578,13579,153157,1.1069901413469534,1.1304516379143246,1.1191305220020347,1.3471536932027395,1.1393472058084189
Hortaleza,2014,Total,74716,81809,156525,16597,173122,67352,72226,139578,13579,153157,1.1093360256562537,1.1326807520837372,1.1214159824614194,1.222254952500184,1.1303564316355112
Hortaleza,2015,Total,76149,83340,159489,15151,174640,67352,72226,139578,13579,153157,1.1306123054994655,1.153878104837593,1.1426514207110003,1.1157669931511893,1.1402678297433353
Hortaleza,2016,Total,77631,84963,162594,15536,178130,67352,72226,139578,13579,153157,1.1526161064259413,1.1763492371168278,1.164897046812535,1.1441195964356727,1.163054904444459
Hortaleza,2017,Total,78777,86066,164843,16036,180879,67352,72226,139578,13579,153157,1.1696311913528923,1.191620745991748,1.1810099012738398,1.180941159142794,1.1810038065514472
Latina,2004,0-24,15697,14838,30535,7739,38274,15697,14838,30535,7739,38274,1.0,1.0,1.0,1.0,1.0
Latina,2005,0-24,14601,13930,28531,8330,36861,15697,14838,30535,7739,38274,0.930177740969612,0.9388057689715595,0.9343703946291141,1.0763664556144206,0.9630819877723781
Latina,2006,0-24,13789,13131,26920,9267,36187,15697,14838,30535,7739,38274,0.8784481111040326,0.8849575414476345,0.8816112657606026,1.1974415299134256,0.9454721220671997
Latina,2007,0-24,12875,12263,25138,9122,34260,15697,14838,30535,7739,38274,0.8202204242848952,0.8264590915217684,0.8232520058948747,1.1787052590774,0.8951246276845901
Latina,2008,0-24,12689,12053,24742,10558,35300,15697,14838,30535,7739,38274,0.80837102631076,0.8123062407332524,0.8102832814802685,1.36425894818452,0.9222971207608298
Latina,2009,0-24,12313,11818,24131,10419,34550,15697,14838,30535,7739,38274,0.7844174045996051,0.7964685267556274,0.7902734566890454,1.3462979713141232,0.9027015728693107
Latina,2010,0-24,12094,11625,23719,9572,33291,15697,14838,30535,7739,38274,0.7704656940816716,0.7834613829357057,0.7767807434092026,1.2368523064995478,0.8698071798087474
Latina,2011,0-24,11989,11496,23485,8603,32088,15697,14838,30535,7739,38274,0.7637765178059501,0.774767488879903,0.769117406255117,1.1116423310505232,0.8383759209907509
Latina,2012,0-24,11999,11554,23553,7270,30823,15697,14838,30535,7739,38274,0.7644135822131618,0.7786763714786359,0.7713443589323727,0.9393978550200285,0.8053247635470554
Latina,2013,0-24,12082,11657,23739,6679,30418,15697,14838,30535,7739,38274,0.7697012167930177,0.7856180078177653,0.7774357294907484,0.8630313994056079,0.7947431676856351
Latina,2014,0-24,12076,11744,23820,5810,29630,15697,14838,30535,7739,38274,0.7693189781486909,0.7914813317158647,0.7800884231210087,0.7507429900503941,0.7741547787009458
Latina,2015,0-24,12208,11773,23981,5235,29216,15697,14838,30535,7739,38274,0.7777282283238836,0.7934357730152312,0.7853610610774521,0.6764439850109834,0.7633380362648273
Latina,2016,0-24,12416,12013,24429,5164,29593,15697,14838,30535,7739,38274,0.7909791679938842,0.809610459630678,0.8000327493040773,0.6672696730843778,0.7731880650049642
Latina,2017,0-24,12561,12059,24620,5119,29739,15697,14838,30535,7739,38274,0.8002166018984519,0.8127106078986386,0.8062878663828393,0.6614549683421631,0.7770026649945132
Latina,2004,25-39,28840,27529,56369,15735,72104,28840,27529,56369,15735,72104,1.0,1.0,1.0,1.0,1.0
Latina,2005,25-39,27279,25936,53215,17902,71117,28840,27529,56369,15735,72104,0.945873786407767,0.9421337498637801,0.9440472600188047,1.1377184620273275,0.9863114390325086
Latina,2006,25-39,25910,24667,50577,20665,71242,28840,27529,56369,15735,72104,0.8984049930651873,0.8960369065349268,0.8972484876439177,1.313314267556403,0.9880450460446022
Latina,2007,25-39,23994,23046,47040,21141,68181,28840,27529,56369,15735,72104,0.8319694868238557,0.8371535471684406,0.8345012329471873,1.3435653002859866,0.9455924775324531
Latina,2008,25-39,23251,22503,45754,22832,68586,28840,27529,56369,15735,72104,0.8062066574202497,0.8174288931672055,0.8116872749206124,1.4510327295837306,0.9512093642516365
Latina,2009,25-39,22282,21558,43840,23463,67303,28840,27529,56369,15735,72104,0.7726074895977808,0.7831014566457191,0.7777324415902358,1.4911344137273594,0.9334156218795073
Latina,2010,25-39,21342,20690,42032,22752,64784,28840,27529,56369,15735,72104,0.7400138696255201,0.7515710705074649,0.7456580744735581,1.4459485224022879,0.8984799733717963
Latina,2011,25-39,20344,19763,40107,21974,62081,28840,27529,56369,15735,72104,0.7054091539528433,0.717897489919721,0.711508098422892,1.3965046075627583,0.8609924553422834
Latina,2012,25-39,19449,18808,38257,19498,57755,28840,27529,56369,15735,72104,0.674375866851595,0.683206800101711,0.6786886409196544,1.2391483952971083,0.8009957838677466
Latina,2013,25-39,18949,18423,37372,17397,54769,28840,27529,56369,15735,72104,0.6570388349514563,0.6692215481855498,0.6629885220599975,1.105624404194471,0.7595833795628537
Latina,2014,25-39,18199,17750,35949,14756,50705,28840,27529,56369,15735,72104,0.6310332871012483,0.644774601329507,0.6377441501534531,0.9377820146170956,0.7032203483856652
Latina,2015,25-39,17635,17389,35024,12914,47938,28840,27529,56369,15735,72104,0.6114771151178918,0.6316611573250027,0.6213344214018344,0.8207181442643787,0.6648452235659603
Latina,2016,25-39,17019,16844,33863,12506,46369,28840,27529,56369,15735,72104,0.590117891816921,0.611863852664463,0.6007379942876404,0.7947886876390213,0.6430849883501609
Latina,2017,25-39,16427,16371,32798,12461,45259,28840,27529,56369,15735,72104,0.5695908460471567,0.5946819717388935,0.581844630914155,0.7919288210994598,0.6276905580827693
Latina,2004,40-64,33300,39487,72787,6677,79464,33300,39487,72787,6677,79464,1.0,1.0,1.0,1.0,1.0
Latina,2005,40-64,33070,39367,72437,8035,80472,33300,39487,72787,6677,79464,0.9930930930930931,0.9969610251475169,0.9951914490224902,1.2033847536318707,1.0126849894291754
Latina,2006,40-64,32144,38308,70452,9800,80252,33300,39487,72787,6677,79464,0.9652852852852852,0.9701420720743535,0.9679200956214709,1.4677250262093755,1.0099164401489984
Latina,2007,40-64,31578,37630,69208,10204,79412,33300,39487,72787,6677,79464,0.9482882882882883,0.9529718641578241,0.9508291315756935,1.528231241575558,0.9993456156246854
Latina,2008,40-64,31470,37405,68875,10958,79833,33300,39487,72787,6677,79464,0.945045045045045,0.9472737863094183,0.9462541387885199,1.6411562078777895,1.0046436122017517
Latina,2009,40-64,31386,36851,68237,11692,79929,33300,39487,72787,6677,79464,0.9425225225225226,0.9332438524071214,0.9374888372923736,1.7510858169836754,1.0058517064331018
Latina,2010,40-64,31341,36393,67734,12194,79928,33300,39487,72787,6677,79464,0.9411711711711712,0.9216450983868109,0.9305782626018383,1.8262692826119515,1.005839122118192
Latina,2011,40-64,31426,36122,67548,12496,80044,33300,39487,72787,6677,79464,0.9437237237237237,0.9147820801782865,0.9280228612252188,1.871499176276771,1.00729890264774
Latina,2012,40-64,31755,36244,67999,11752,79751,33300,39487,72787,6677,79464,0.9536036036036036,0.9178717046116444,0.934219022627667,1.7600718885727122,1.0036116983791403
Latina,2013,40-64,32265,36439,68704,11338,80042,33300,39487,72787,6677,79464,0.9689189189189189,0.9228100387469294,0.9439048181680795,1.698067994608357,1.00727373401792
Latina,2014,40-64,32599,36386,68985,10492,79477,33300,39487,72787,6677,79464,0.9789489489489489,0.9214678248537493,0.9477653976671658,1.5713643852029355,1.0001635960938287
Latina,2015,40-64,33031,36697,69728,9766,79494,33300,39487,72787,6677,79464,0.991921921921922,0.929343834679768,0.957973264456565,1.4626329189755878,1.000377529447297
Latina,2016,40-64,33518,37057,70575,10066,80641,33300,39487,72787,6677,79464,1.0065465465465466,0.9384607592372173,0.9696099578221385,1.5075632769207727,1.014811738648948
Latina,2017,40-64,33825,37403,71228,10463,81691,33300,39487,72787,6677,79464,1.0157657657657657,0.9472231367285435,0.9785813400744638,1.5670211172682342,1.028025269304339
Latina,2004,65-84,20184,26404,46588,502,47090,20184,26404,46588,502,47090,1.0,1.0,1.0,1.0,1.0
Latina,2005,65-84,20194,26489,46683,590,47273,20184,26404,46588,502,47090,1.0004954419342054,1.0032192092107257,1.0020391517128875,1.1752988047808766,1.0038861754087918
Latina,2006,65-84,20822,27175,47997,706,48703,20184,26404,46588,502,47090,1.0316091954022988,1.0292001211937585,1.0302438396153515,1.406374501992032,1.0342535570184752
Latina,2007,65-84,21191,27538,48729,564,49293,20184,26404,46588,502,47090,1.0498910027744748,1.0429480381760339,1.0459560401820212,1.1235059760956174,1.0467827564238692
Latina,2008,65-84,21191,27593,48784,543,49327,20184,26404,46588,502,47090,1.0498910027744748,1.045031055900621,1.0471366017000086,1.0816733067729083,1.047504778084519
Latina,2009,65-84,21358,28187,49545,583,50128,20184,26404,46588,502,47090,1.0581648830757036,1.0675276473261628,1.0634712801579806,1.1613545816733069,1.0645147589721808
Latina,2010,65-84,21559,28740,50299,640,50939,20184,26404,46588,502,47090,1.0681232659532303,1.0884714437206484,1.0796557053318452,1.2749003984063745,1.0817370991717987
Latina,2011,65-84,21613,29079,50692,677,51369,20184,26404,46588,502,47090,1.070798652397939,1.101310407514013,1.0880913539967374,1.348605577689243,1.0908685495858994
Latina,2012,65-84,21447,29149,50596,661,51257,20184,26404,46588,502,47090,1.0625743162901309,1.1039615209816696,1.0860307375289775,1.3167330677290836,1.088490125291994
Latina,2013,65-84,21336,29305,50641,697,51338,20184,26404,46588,502,47090,1.0570749108204518,1.1098697167095894,1.0869966514982399,1.3884462151394423,1.0902102357188364
Latina,2014,65-84,21088,29355,50443,704,51147,20184,26404,46588,502,47090,1.04478795085216,1.111763369186487,1.082746630033485,1.402390438247012,1.08615417286048
Latina,2015,65-84,20860,29278,50138,684,50822,20184,26404,46588,502,47090,1.033491874752279,1.1088471443720649,1.0761998797973726,1.3625498007968126,1.0792524952219156
Latina,2016,65-84,20612,29074,49686,730,50416,20184,26404,46588,502,47090,1.0212049147839872,1.1011210422663233,1.066497810595003,1.454183266932271,1.0706307071565089
Latina,2017,65-84,20170,28651,48821,803,49624,20184,26404,46588,502,47090,0.9993063812921126,1.085100742311771,1.047930797630291,1.599601593625498,1.0538118496496072
Latina,2004,85-100,1577,3720,5297,38,5335,1577,3720,5297,38,5335,1.0,1.0,1.0,1.0,1.0
Latina,2005,85-100,1597,3836,5433,39,5472,1577,3720,5297,38,5335,1.0126823081800889,1.0311827956989248,1.0256749103265999,1.0263157894736843,1.0256794751640113
Latina,2006,85-100,1648,4016,5664,51,5715,1577,3720,5297,38,5335,1.0450221940393152,1.0795698924731183,1.0692845006607514,1.3421052631578947,1.0712277413308342
Latina,2007,85-100,1902,4417,6319,32,6351,1577,3720,5297,38,5335,1.2060875079264426,1.1873655913978494,1.192939399660185,0.8421052631578947,1.190440487347704
Latina,2008,85-100,1887,4353,6240,28,6268,1577,3720,5297,38,5335,1.196575776791376,1.1701612903225806,1.178025297338116,0.7368421052631579,1.1748828491096532
Latina,2009,85-100,2030,4538,6568,35,6603,1577,3720,5297,38,5335,1.2872542802790108,1.2198924731182796,1.239947139890504,0.9210526315789473,1.2376757263355203
Latina,2010,85-100,2156,4746,6902,32,6934,1577,3720,5297,38,5335,1.36715282181357,1.2758064516129033,1.303001699074948,0.8421052631578947,1.2997188378631677
Latina,2011,85-100,2291,4989,7280,37,7317,1577,3720,5297,38,5335,1.4527584020291693,1.3411290322580645,1.3743628468944686,0.9736842105263158,1.3715089034676664
Latina,2012,85-100,2422,5251,7673,29,7702,1577,3720,5297,38,5335,1.5358275206087508,1.4115591397849463,1.4485557862941287,0.7631578947368421,1.4436738519212746
Latina,2013,85-100,2574,5418,7992,29,8021,1577,3720,5297,38,5335,1.6322130627774254,1.456451612903226,1.508778553898433,0.7631578947368421,1.5034676663542643
Latina,2014,85-100,2781,5733,8514,30,8544,1577,3720,5297,38,5335,1.7634749524413442,1.5411290322580644,1.6073249008872947,0.7894736842105263,1.6014995313964386
Latina,2015,85-100,2942,5878,8820,32,8852,1577,3720,5297,38,5335,1.865567533291059,1.5801075268817204,1.6650934491221445,0.8421052631578947,1.6592314901593253
Latina,2016,85-100,3122,6140,9262,35,9297,1577,3720,5297,38,5335,1.979708306911858,1.6505376344086022,1.7485369076835944,0.9210526315789473,1.7426429240862231
Latina,2017,85-100,3366,6385,9751,43,9794,1577,3720,5297,38,5335,2.134432466708941,1.7163978494623655,1.8408533131961489,1.131578947368421,1.8358013120899719
Latina,2004,Total,107431,119493,226924,34104,261028,107431,119493,226924,34104,261028,1.0,1.0,1.0,1.0,1.0
Latina,2005,Total,104673,117067,221740,38529,260269,107431,119493,226924,34104,261028,0.974327708017239,0.9796975555053434,0.9771553471646895,1.129750175932442,0.9970922659638046
Latina,2006,Total,102361,114949,217310,44383,261693,107431,119493,226924,34104,261028,0.9528069179287171,0.9619726678550208,0.9576333926777247,1.3014015951208069,1.0025476194124767
Latina,2007,Total,99465,112400,211865,44594,256459,107431,119493,226924,34104,261028,0.9258500805167968,0.9406408743608412,0.9336385750295253,1.3075885526624442,0.9824961306832983
Latina,2008,Total,98718,111697,210415,48928,259343,107431,119493,226924,34104,261028,0.9188967802589569,0.9347576845505594,0.9272487705134759,1.4346704198920948,0.9935447538195136
Latina,2009,Total,97817,111012,208829,50349,259178,107431,119493,226924,34104,261028,0.910510001768577,0.9290251311792322,0.9202596464014383,1.4763370865587615,0.9929126377246885
Latina,2010,Total,97031,110355,207386,49150,256536,107431,119493,226924,34104,261028,0.9031936778024965,0.92352690115739,0.9139006892175354,1.4411799202439597,0.9827911181942167
Latina,2011,Total,96265,109726,205991,47608,253599,107431,119493,226924,34104,261028,0.8960635198406419,0.9182629944850326,0.9077532565969223,1.3959652826647901,0.9715394517063304
Latina,2012,Total,95470,109207,204677,42749,247426,107431,119493,226924,34104,261028,0.8886634211726596,0.9139196438285088,0.901962771676861,1.2534893267651888,0.9478906477466019
Latina,2013,Total,95575,109364,204939,39554,244493,107431,119493,226924,34104,261028,0.889640792694846,0.9152335283238349,0.9031173432514851,1.159805301430917,0.9366543052852567
Latina,2014,Total,94965,108911,203876,34982,238858,107431,119493,226924,34104,261028,0.883962729565954,0.9114425112768112,0.8984329555269606,1.025744780670889,0.9150665828953216
Latina,2015,Total,94688,108724,203412,31427,234839,107431,119493,226924,34104,261028,0.8813843304074243,0.9098775660498941,0.8963882180818248,0.9215048088200798,0.8996697672280368
Latina,2016,Total,94623,108810,203433,31250,234683,107431,119493,226924,34104,261028,0.8807792908936899,0.9105972734804549,0.896480760078264,0.9163148017827821,0.8990721301929295
Latina,2017,Total,94244,108496,202740,31746,234486,107431,119493,226924,34104,261028,0.8772514451136078,0.9079695044898027,0.8934268741957659,0.9308585503166784,0.8983174218857747
Moncloa - Aravaca,2004,0-24,7683,7529,15212,2547,17759,7683,7529,15212,2547,17759,1.0,1.0,1.0,1.0,1.0
Moncloa - Aravaca,2005,0-24,7473,7388,14861,2671,17532,7683,7529,15212,2547,17759,0.9726669269816478,0.9812724133351043,0.9769261109650276,1.0486847271299569,0.9872177487471141
Moncloa - Aravaca,2006,0-24,7265,7207,14472,2761,17233,7683,7529,15212,2547,17759,0.9455941689444227,0.9572320361269757,0.9513541940573231,1.0840204161758933,0.9703812151585112
Moncloa - Aravaca,2007,0-24,7061,7097,14158,2342,16500,7683,7529,15212,2547,17759,0.9190420408694521,0.9426218621330854,0.9307125953194846,0.9195131527287004,0.9291063686018357
Moncloa - Aravaca,2008,0-24,7066,7217,14283,2532,16815,7683,7529,15212,2547,17759,0.91969282832227,0.9585602337627839,0.9389297922692611,0.9941107184923439,0.946843853820598
Moncloa - Aravaca,2009,0-24,7088,7101,14189,2575,16764,7683,7529,15212,2547,17759,0.9225562931146688,0.9431531411874087,0.9327504601630292,1.010993325480958,0.9439720704994651
Moncloa - Aravaca,2010,0-24,7117,7132,14249,2427,16676,7683,7529,15212,2547,17759,0.9263308603410126,0.9472705538584141,0.9366947146989218,0.9528857479387515,0.9390168365335886
Moncloa - Aravaca,2011,0-24,7139,7183,14322,2214,16536,7683,7529,15212,2547,17759,0.9291943251334114,0.954044361801036,0.9414935577175914,0.8692579505300353,0.9311335097696942
Moncloa - Aravaca,2012,0-24,7249,7230,14479,1995,16474,7683,7529,15212,2547,17759,0.9435116490954054,0.9602868906893346,0.9518143570865106,0.7832744405182568,0.9276423222028267
Moncloa - Aravaca,2013,0-24,7353,7333,14686,2058,16744,7683,7529,15212,2547,17759,0.957048028114018,0.9739673263381591,0.9654220352353405,0.8080094228504122,0.9428458809617659
Moncloa - Aravaca,2014,0-24,7411,7371,14782,2044,16826,7683,7529,15212,2547,17759,0.9645971625667057,0.9790144773542303,0.9717328424927688,0.8025127601099332,0.9474632580663326
Moncloa - Aravaca,2015,0-24,7630,7533,15163,2067,17230,7683,7529,15212,2547,17759,0.9931016530001302,1.0005312790543233,0.9967788587956876,0.8115429917550059,0.9702122867278563
Moncloa - Aravaca,2016,0-24,7781,7687,15468,2004,17472,7683,7529,15212,2547,17759,1.012755434075231,1.0209855226457696,1.0168288193531423,0.7868080094228505,0.9838391801340165
Moncloa - Aravaca,2017,0-24,7967,7808,15775,1907,17682,7683,7529,15212,2547,17759,1.0369647273200573,1.037056714039049,1.0370102550617932,0.7487239890066745,0.9956641702798581
Moncloa - Aravaca,2004,25-39,12157,12413,24570,6136,30706,12157,12413,24570,6136,30706,1.0,1.0,1.0,1.0,1.0
Moncloa - Aravaca,2005,25-39,11627,11900,23527,7158,30685,12157,12413,24570,6136,30706,0.9564037180225384,0.9586723596229759,0.9575498575498576,1.1665580182529336,0.9993160945743503
Moncloa - Aravaca,2006,25-39,11184,11376,22560,7709,30269,12157,12413,24570,6136,30706,0.9199638068602451,0.9164585515185693,0.9181929181929182,1.25635593220339,0.9857682537614798
Moncloa - Aravaca,2007,25-39,10443,10675,21118,6721,27839,12157,12413,24570,6136,30706,0.8590112692276055,0.8599854990735519,0.8595034595034595,1.0953389830508475,0.9066306259362991
Moncloa - Aravaca,2008,25-39,10358,10608,20966,6891,27857,12157,12413,24570,6136,30706,0.8520194126840503,0.8545879320067671,0.8533170533170533,1.1230443285528031,0.907216830586856
Moncloa - Aravaca,2009,25-39,10068,10384,20452,7234,27686,12157,12413,24570,6136,30706,0.8281648433001563,0.8365423346491582,0.8323972323972324,1.1789439374185138,0.9016478864065655
Moncloa - Aravaca,2010,25-39,9826,10177,20003,7381,27384,12157,12413,24570,6136,30706,0.8082586164349758,0.8198662692338677,0.8141229141229142,1.2029009126466754,0.8918126750472221
Moncloa - Aravaca,2011,25-39,9722,10032,19754,7258,27012,12157,12413,24570,6136,30706,0.7997038743110965,0.8081849673729155,0.803988603988604,1.1828552803129075,0.8796977789357129
Moncloa - Aravaca,2012,25-39,9427,9727,19154,6439,25593,12157,12413,24570,6136,30706,0.7754380192481698,0.7836139531136711,0.7795685795685796,1.049380704041721,0.833485312316811
Moncloa - Aravaca,2013,25-39,9255,9553,18808,6087,24895,12157,12413,24570,6136,30706,0.7612897918894465,0.7695963908805284,0.7654863654863655,0.9920143415906127,0.8107535986452159
Moncloa - Aravaca,2014,25-39,9041,9237,18278,5445,23723,12157,12413,24570,6136,30706,0.7436867648268487,0.7441392088939015,0.7439153439153439,0.8873859191655802,0.7725851625089559
Moncloa - Aravaca,2015,25-39,9014,9208,18222,4759,22981,12157,12413,24570,6136,30706,0.7414658221600724,0.7418029485217111,0.7416361416361417,0.7755867014341591,0.7484205041359995
Moncloa - Aravaca,2016,25-39,8960,9098,18058,4740,22798,12157,12413,24570,6136,30706,0.7370239368265197,0.7329412712478853,0.734961334961335,0.772490221642764,0.7424607568553377
Moncloa - Aravaca,2017,25-39,8764,8911,17675,4576,22251,12157,12413,24570,6136,30706,0.7209015382084396,0.7178764198823814,0.7193732193732194,0.7457627118644068,0.7246466488634143
Moncloa - Aravaca,2004,40-64,15923,18475,34398,3446,37844,15923,18475,34398,3446,37844,1.0,1.0,1.0,1.0,1.0
Moncloa - Aravaca,2005,40-64,16272,18707,34979,4171,39150,15923,18475,34398,3446,37844,1.021917980280098,1.0125575101488498,1.016890516890517,1.210388856645386,1.0345100940703942
Moncloa - Aravaca,2006,40-64,16407,18868,35275,4705,39980,15923,18475,34398,3446,37844,1.0303962821076431,1.0212719891745603,1.0254956683528111,1.3653511317469529,1.0564422365500477
Moncloa - Aravaca,2007,40-64,16496,19046,35542,4178,39720,15923,18475,34398,3446,37844,1.0359856810902468,1.0309066305818675,1.033257747543462,1.212420197330238,1.049571926857626
Moncloa - Aravaca,2008,40-64,16687,19211,35898,4161,40059,15923,18475,34398,3446,37844,1.047980908120329,1.0398376184032476,1.0436071864643293,1.2074869413813116,1.0585297537258218
Moncloa - Aravaca,2009,40-64,16888,19408,36296,4386,40682,15923,18475,34398,3446,37844,1.0606041575080072,1.0505006765899865,1.055177626606198,1.2727800348229832,1.0749920727195856
Moncloa - Aravaca,2010,40-64,17013,19510,36523,4571,41094,15923,18475,34398,3446,37844,1.0684544369779565,1.056021650879567,1.061776847491133,1.3264654672083576,1.085878871155269
Moncloa - Aravaca,2011,40-64,17074,19619,36693,4643,41336,15923,18475,34398,3446,37844,1.0722853733592916,1.0619215155615698,1.066718995290424,1.3473592571096924,1.0922735440228306
Moncloa - Aravaca,2012,40-64,17154,19647,36801,4083,40884,15923,18475,34398,3446,37844,1.077309552220059,1.0634370771312585,1.0698587127158556,1.1848520023215323,1.0803297748652363
Moncloa - Aravaca,2013,40-64,17232,19732,36964,3994,40958,15923,18475,34398,3446,37844,1.0822081266093073,1.0680378890392421,1.074597360311646,1.1590249564712711,1.0822851707007717
Moncloa - Aravaca,2014,40-64,17151,19531,36682,3796,40478,15923,18475,34398,3446,37844,1.0771211455127803,1.0571583220568335,1.0663992092563521,1.1015670342426,1.0696015220378396
Moncloa - Aravaca,2015,40-64,17455,19813,37268,3561,40829,15923,18475,34398,3446,37844,1.0962130251836966,1.0724221921515562,1.0834350834350834,1.0333720255368544,1.0788764401226085
Moncloa - Aravaca,2016,40-64,17578,19924,37502,3643,41145,15923,18475,34398,3446,37844,1.1039377001821264,1.0784303112313938,1.0902378045235188,1.0571677307022636,1.0872265088257056
Moncloa - Aravaca,2017,40-64,17634,20002,37636,3796,41432,15923,18475,34398,3446,37844,1.1074546253846638,1.0826522327469554,1.0941333798476656,1.1015670342426,1.094810273755417
Moncloa - Aravaca,2004,65-84,7291,11020,18311,367,18678,7291,11020,18311,367,18678,1.0,1.0,1.0,1.0,1.0
Moncloa - Aravaca,2005,65-84,7169,10900,18069,414,18483,7291,11020,18311,367,18678,0.9832670415580853,0.9891107078039928,0.9867839003877451,1.1280653950953679,0.9895599100546097
Moncloa - Aravaca,2006,65-84,7265,11008,18273,430,18703,7291,11020,18311,367,18678,0.9964339596763132,0.9989110707803993,0.9979247446889847,1.1716621253405994,1.0013384730699217
Moncloa - Aravaca,2007,65-84,7386,11039,18425,355,18780,7291,11020,18311,367,18678,1.013029762721163,1.0017241379310344,1.0062257659330458,0.9673024523160763,1.005460970125281
Moncloa - Aravaca,2008,65-84,7378,11048,18426,339,18765,7291,11020,18311,367,18678,1.011932519544644,1.002540834845735,1.0062803779149145,0.9237057220708447,1.004657886283328
Moncloa - Aravaca,2009,65-84,7442,11072,18514,354,18868,7291,11020,18311,367,18678,1.020710464956796,1.0047186932849366,1.0110862323193708,0.9645776566757494,1.010172395331406
Moncloa - Aravaca,2010,65-84,7536,11158,18694,384,19078,7291,11020,18311,367,18678,1.0336030722808942,1.0125226860254084,1.0209163890557589,1.0463215258855585,1.0214155691187494
Moncloa - Aravaca,2011,65-84,7695,11240,18935,408,19343,7291,11020,18311,367,18678,1.0554107804142092,1.0199637023593466,1.034077876686145,1.111716621253406,1.0356033836599208
Moncloa - Aravaca,2012,65-84,7777,11325,19102,382,19484,7291,11020,18311,367,18678,1.0666575229735291,1.0276769509981851,1.0431980776582381,1.0408719346049047,1.0431523717742799
Moncloa - Aravaca,2013,65-84,7923,11488,19411,388,19799,7291,11020,18311,367,18678,1.0866822109450007,1.0424682395644282,1.0600731800557042,1.0572207084468666,1.060017132455295
Moncloa - Aravaca,2014,65-84,8093,11587,19680,384,20064,7291,11020,18311,367,18678,1.1099986284460293,1.0514519056261342,1.0747638031784172,1.0463215258855585,1.0742049469964665
Moncloa - Aravaca,2015,65-84,8165,11713,19878,380,20258,7291,11020,18311,367,18678,1.1198738170347002,1.0628856624319418,1.0855769755884441,1.0354223433242506,1.0845914980190599
Moncloa - Aravaca,2016,65-84,8287,11783,20070,416,20486,7291,11020,18311,367,18678,1.136606775476615,1.0692377495462795,1.096062476107258,1.1335149863760219,1.096798372416747
Moncloa - Aravaca,2017,65-84,8447,11795,20242,452,20694,7291,11020,18311,367,18678,1.158551639006995,1.0703266787658803,1.1054557369886953,1.231607629427793,1.1079344683584966
Moncloa - Aravaca,2004,85-100,846,2283,3129,46,3175,846,2283,3129,46,3175,1.0,1.0,1.0,1.0,1.0
Moncloa - Aravaca,2005,85-100,854,2255,3109,53,3162,846,2283,3129,46,3175,1.0094562647754137,0.9877354358300482,0.9936081815276446,1.1521739130434783,0.9959055118110236
Moncloa - Aravaca,2006,85-100,870,2292,3162,66,3228,846,2283,3129,46,3175,1.0283687943262412,1.0039421813403417,1.0105465004793863,1.434782608695652,1.0166929133858267
Moncloa - Aravaca,2007,85-100,990,2488,3478,54,3532,846,2283,3129,46,3175,1.1702127659574468,1.0897941305300043,1.1115372323426014,1.173913043478261,1.1124409448818897
Moncloa - Aravaca,2008,85-100,968,2515,3483,58,3541,846,2283,3129,46,3175,1.1442080378250592,1.1016206745510293,1.1131351869606902,1.2608695652173914,1.115275590551181
Moncloa - Aravaca,2009,85-100,1010,2602,3612,56,3668,846,2283,3129,46,3175,1.1938534278959811,1.1397284275076653,1.1543624161073827,1.2173913043478262,1.1552755905511811
Moncloa - Aravaca,2010,85-100,1072,2705,3777,56,3833,846,2283,3129,46,3175,1.2671394799054374,1.184844502847131,1.2070949185043145,1.2173913043478262,1.207244094488189
Moncloa - Aravaca,2011,85-100,1077,2797,3874,58,3932,846,2283,3129,46,3175,1.2730496453900708,1.2251423565484012,1.2380952380952381,1.2608695652173914,1.2384251968503937
Moncloa - Aravaca,2012,85-100,1118,2884,4002,46,4048,846,2283,3129,46,3175,1.3215130023640662,1.2632501095050372,1.2790028763183126,1.0,1.27496062992126
Moncloa - Aravaca,2013,85-100,1128,2947,4075,48,4123,846,2283,3129,46,3175,1.3333333333333333,1.2908453788874288,1.3023330137424096,1.0434782608695652,1.2985826771653544
Moncloa - Aravaca,2014,85-100,1210,3057,4267,47,4314,846,2283,3129,46,3175,1.4302600472813238,1.3390275952693824,1.3636944710770214,1.0217391304347827,1.358740157480315
Moncloa - Aravaca,2015,85-100,1301,3193,4494,39,4533,846,2283,3129,46,3175,1.537825059101655,1.3985983355234342,1.436241610738255,0.8478260869565217,1.427716535433071
Moncloa - Aravaca,2016,85-100,1373,3297,4670,40,4710,846,2283,3129,46,3175,1.6229314420803782,1.4441524310118266,1.4924896132949825,0.8695652173913043,1.4834645669291338
Moncloa - Aravaca,2017,85-100,1418,3427,4845,44,4889,846,2283,3129,46,3175,1.6761229314420805,1.501095050372317,1.548418024928092,0.9565217391304348,1.5398425196850394
Moncloa - Aravaca,2004,Total,48761,56635,105396,13729,119125,48761,56635,105396,13729,119125,1.0,1.0,1.0,1.0,1.0
Moncloa - Aravaca,2005,Total,48383,56180,104563,15667,120230,48761,56635,105396,13729,119125,0.9922479030372634,0.991966098702216,0.9920964742494971,1.1411610459611041,1.0092759706190977
Moncloa - Aravaca,2006,Total,48061,55789,103850,16841,120691,48761,56635,105396,13729,119125,0.9856442648838211,0.9850622406639005,0.98533151163232,1.226673464928254,1.013145855194124
Moncloa - Aravaca,2007,Total,47428,55234,102662,14604,117266,48761,56635,105396,13729,119125,0.9726625787001907,0.9752626467731967,0.9740597366123952,1.0637337023818194,0.9843945435466946
Moncloa - Aravaca,2008,Total,47808,55684,103492,14953,118445,48761,56635,105396,13729,119125,0.9804556920489735,0.9832082634413348,0.9819347982845649,1.0891543448175396,0.9942917103882476
Moncloa - Aravaca,2009,Total,47944,55716,103660,15634,119294,48761,56635,105396,13729,119125,0.9832448063001169,0.9837732850710691,0.9835287866712209,1.138757374899847,1.0014186778593914
Moncloa - Aravaca,2010,Total,47967,55758,103725,15801,119526,48761,56635,105396,13729,119125,0.9837164947396485,0.9845148759600953,0.9841455083684391,1.1509214072401486,1.0033662119622246
Moncloa - Aravaca,2011,Total,48133,55980,104113,15522,119635,48761,56635,105396,13729,119125,0.9871208547814853,0.9884347135163768,0.9878268624995256,1.130599460994974,1.0042812172088142
Moncloa - Aravaca,2012,Total,48013,55759,103772,13808,117580,48761,56635,105396,13729,119125,0.9846598716187117,0.9845325328860245,0.9845914455956583,1.0057542428436157,0.9870304302203567
Moncloa - Aravaca,2013,Total,48165,56023,104188,13444,117632,48761,56635,105396,13729,119125,0.9877771169582248,0.9891939613313322,0.9885384644578542,0.9792410226527788,0.9874669464847848
Moncloa - Aravaca,2014,Total,48011,55596,103607,12540,116147,48761,56635,105396,13729,119125,0.9846188552326655,0.9816544539595656,0.9830259212873353,0.9133950032777333,0.9750010493179433
Moncloa - Aravaca,2015,Total,48521,56182,104703,11577,116280,48761,56635,105396,13729,119125,0.9950780336744529,0.9920014125540744,0.9934247979050438,0.8432515113992279,0.9761175236096538
Moncloa - Aravaca,2016,Total,48903,56502,105405,11630,117035,48761,56635,105396,13729,119125,1.002912163409282,0.997651628851417,1.0000853922349995,0.847111952800641,0.9824554039874082
Moncloa - Aravaca,2017,Total,49109,56626,105735,11575,117310,48761,56635,105396,13729,119125,1.0071368511720433,0.9998410876666373,1.0032164408516453,0.8431058343652124,0.9847639034627492
Moratalaz,2004,0-24,7466,6979,14445,1903,16348,7466,6979,14445,1903,16348,1.0,1.0,1.0,1.0,1.0
Moratalaz,2005,0-24,7243,6782,14025,1878,15903,7466,6979,14445,1903,16348,0.9701312617197964,0.9717724602378565,0.9709241952232607,0.9868628481345244,0.9727795448984585
Moratalaz,2006,0-24,6978,6523,13501,2130,15631,7466,6979,14445,1903,16348,0.9346370211626038,0.9346611262358504,0.9346486673589477,1.1192853389385182,0.956141424027404
Moratalaz,2007,0-24,6652,6280,12932,2207,15139,7466,6979,14445,1903,16348,0.8909724082507366,0.8998423842957444,0.895257874697127,1.159747766684183,0.9260459995106435
Moratalaz,2008,0-24,6542,6203,12745,2576,15321,7466,6979,14445,1903,16348,0.8762389499062416,0.8888092849978507,0.8823122187608169,1.3536521282186023,0.9371788597993639
Moratalaz,2009,0-24,6444,6097,12541,2563,15104,7466,6979,14445,1903,16348,0.8631127779266006,0.8736208625877633,0.8681896850121149,1.346820809248555,0.9239050648397358
Moratalaz,2010,0-24,6391,6045,12436,2298,14734,7466,6979,14445,1903,16348,0.8560139298151621,0.8661699383865883,0.8609207338179301,1.207566999474514,0.9012723268901395
Moratalaz,2011,0-24,6353,6041,12394,2077,14471,7466,6979,14445,1903,16348,0.8509241896597911,0.8655967903711134,0.8580131533402562,1.09143457698371,0.8851847320773183
Moratalaz,2012,0-24,6349,6045,12394,1765,14159,7466,6979,14445,1903,16348,0.850388427538173,0.8661699383865883,0.8580131533402562,0.9274829217025748,0.8660998287252263
Moratalaz,2013,0-24,6348,6018,12366,1561,13927,7466,6979,14445,1903,16348,0.8502544870077685,0.8623011892821321,0.8560747663551402,0.8202837624802942,0.8519084903352092
Moratalaz,2014,0-24,6317,6048,12365,1382,13747,7466,6979,14445,1903,16348,0.846102330565229,0.8665997993981945,0.8560055382485289,0.7262217551234892,0.8408979691705407
Moratalaz,2015,0-24,6267,6031,12298,1210,13508,7466,6979,14445,1903,16348,0.839405304045004,0.8641639203324258,0.8513672551055729,0.6358381502890174,0.8262784438463421
Moratalaz,2016,0-24,6233,6064,12297,1371,13668,7466,6979,14445,1903,16348,0.834851326011251,0.8688923914600946,0.8512980269989616,0.72044140830268,0.8360655737704918
Moratalaz,2017,0-24,6219,6035,12254,1381,13635,7466,6979,14445,1903,16348,0.832976158585588,0.8647370683479009,0.8483212184146763,0.7256962690488702,0.8340469782236359
Moratalaz,2004,25-39,12363,12336,24699,3802,28501,12363,12336,24699,3802,28501,1.0,1.0,1.0,1.0,1.0
Moratalaz,2005,25-39,11535,11583,23118,4249,27367,12363,12336,24699,3802,28501,0.933025964571706,0.9389591439688716,0.9359893113081501,1.1175697001578118,0.9602119223886881
Moratalaz,2006,25-39,10844,10851,21695,4890,26585,12363,12336,24699,3802,28501,0.877133381865243,0.8796206225680934,0.8783756427385724,1.2861651762230406,0.9327742886214518
Moratalaz,2007,25-39,9877,9883,19760,4871,24631,12363,12336,24699,3802,28501,0.7989161206826823,0.8011511024643321,0.8000323899753027,1.2811678064176748,0.8642152906915547
Moratalaz,2008,25-39,9447,9448,18895,5280,24175,12363,12336,24699,3802,28501,0.7641349187090511,0.7658884565499352,0.765010729179319,1.3887427669647554,0.8482158520753658
Moratalaz,2009,25-39,8866,8958,17824,5412,23236,12363,12336,24699,3802,28501,0.7171398527865405,0.7261673151750972,0.7216486497429045,1.4234613361388744,0.8152696396617662
Moratalaz,2010,25-39,8433,8422,16855,5215,22070,12363,12336,24699,3802,28501,0.6821159912642563,0.6827172503242542,0.6824162921575773,1.3716465018411363,0.7743587944282657
Moratalaz,2011,25-39,8006,7879,15885,4966,20851,12363,12336,24699,3802,28501,0.6475774488392785,0.6386997405966277,0.6431434471031215,1.306154655444503,0.7315883653205151
Moratalaz,2012,25-39,7583,7479,15062,4512,19574,12363,12336,24699,3802,28501,0.6133624524791718,0.6062743190661478,0.6098222600105268,1.1867438190426092,0.6867829198975475
Moratalaz,2013,25-39,7227,7174,14401,3996,18397,12363,12336,24699,3802,28501,0.584566852705654,0.581549935149157,0.5830600429167173,1.051025775907417,0.6454861232939195
Moratalaz,2014,25-39,6953,6853,13806,3443,17249,12363,12336,24699,3802,28501,0.5624039472619914,0.5555285343709468,0.5589699987853759,0.9055760126249343,0.6052068348479
Moratalaz,2015,25-39,6712,6737,13449,2952,16401,12363,12336,24699,3802,28501,0.5429102968535146,0.5461251621271076,0.5445159723065711,0.7764334560757497,0.5754534928598997
Moratalaz,2016,25-39,6585,6509,13094,2860,15954,12363,12336,24699,3802,28501,0.5326377092938607,0.5276426718547341,0.5301429207660229,0.7522356654392425,0.5597698326374513
Moratalaz,2017,25-39,6471,6425,12896,2830,15726,12363,12336,24699,3802,28501,0.5234166464450376,0.5208333333333334,0.5221264018786186,0.7443450815360336,0.5517701133293569
Moratalaz,2004,40-64,14260,16732,30992,1619,32611,14260,16732,30992,1619,32611,1.0,1.0,1.0,1.0,1.0
Moratalaz,2005,40-64,14446,16883,31329,1894,33223,14260,16732,30992,1619,32611,1.0130434782608695,1.009024623475974,1.0108737738771296,1.169857936998147,1.0187666738217167
Moratalaz,2006,40-64,14392,16696,31088,2237,33325,14260,16732,30992,1619,32611,1.0092566619915848,0.9978484341381784,1.0030975735673722,1.3817171093267449,1.0218944527920026
Moratalaz,2007,40-64,14444,16746,31190,2276,33466,14260,16732,30992,1619,32611,1.0129032258064516,1.0008367200573751,1.0063887454827052,1.4058060531192094,1.0262181472509275
Moratalaz,2008,40-64,14428,16731,31159,2368,33527,14260,16732,30992,1619,32611,1.011781206171108,0.999940234281616,1.0053884873515746,1.4626312538604076,1.0280886817331576
Moratalaz,2009,40-64,14447,16664,31111,2563,33674,14260,16732,30992,1619,32611,1.0131136044880786,0.9959359311498924,1.0038397005678885,1.5830759728227302,1.0325963631903345
Moratalaz,2010,40-64,14538,16689,31227,2746,33973,14260,16732,30992,1619,32611,1.0194950911640954,0.9974300741094908,1.0075826019617966,1.696108709079679,1.041765048603232
Moratalaz,2011,40-64,14546,16712,31258,2818,34076,14260,16732,30992,1619,32611,1.0200561009817672,0.9988046856323213,1.0085828600929272,1.740580605311921,1.0449234920732269
Moratalaz,2012,40-64,14606,16826,31432,2706,34138,14260,16732,30992,1619,32611,1.0242636746143057,1.0056179775280898,1.0141972121837894,1.6714021000617665,1.0468246910551655
Moratalaz,2013,40-64,14637,16875,31512,2552,34064,14260,16732,30992,1619,32611,1.026437587657784,1.0085464977289027,1.016778523489933,1.5762816553428043,1.0445555180767225
Moratalaz,2014,40-64,14643,16781,31424,2388,33812,14260,16732,30992,1619,32611,1.0268583450210378,1.002928520200813,1.013939081053175,1.4749845583693637,1.0368280641501333
Moratalaz,2015,40-64,14622,16786,31408,2275,33683,14260,16732,30992,1619,32611,1.0253856942496493,1.0032273487927326,1.0134228187919463,1.4051883878937617,1.0328723436877127
Moratalaz,2016,40-64,14641,16867,31508,2327,33835,14260,16732,30992,1619,32611,1.02671809256662,1.0080683719818313,1.0166494579246257,1.4373069796170475,1.0375333476434332
Moratalaz,2017,40-64,14572,16824,31396,2408,33804,14260,16732,30992,1619,32611,1.0218793828892005,1.005498446091322,1.0130356220960248,1.48733786287832,1.0365827481524639
Moratalaz,2004,65-84,8358,11086,19444,206,19650,8358,11086,19444,206,19650,1.0,1.0,1.0,1.0,1.0
Moratalaz,2005,65-84,8344,11145,19489,240,19729,8358,11086,19444,206,19650,0.998324958123953,1.005322027782789,1.002314338613454,1.1650485436893203,1.0040203562340968
Moratalaz,2006,65-84,8464,11460,19924,279,20203,8358,11086,19444,206,19650,1.0126824599186408,1.0337362439112394,1.0246862785435096,1.354368932038835,1.028142493638677
Moratalaz,2007,65-84,8639,11716,20355,246,20601,8358,11086,19444,206,19650,1.033620483369227,1.0568284322569006,1.0468524994857025,1.1941747572815533,1.0483969465648855
Moratalaz,2008,65-84,8586,11802,20388,251,20639,8358,11086,19444,206,19650,1.0272792534099067,1.0645859642792712,1.0485496811355688,1.2184466019417475,1.0503307888040712
Moratalaz,2009,65-84,8658,11992,20650,264,20914,8358,11086,19444,206,19650,1.0358937544867193,1.0817246978170665,1.0620242748405677,1.2815533980582525,1.064325699745547
Moratalaz,2010,65-84,8695,12205,20900,261,21161,8358,11086,19444,206,19650,1.0403206508734146,1.1009381201515425,1.074881711581979,1.266990291262136,1.0768956743002545
Moratalaz,2011,65-84,8763,12326,21089,262,21351,8358,11086,19444,206,19650,1.048456568557071,1.1118527872992965,1.084601933758486,1.2718446601941749,1.0865648854961831
Moratalaz,2012,65-84,8668,12296,20964,284,21248,8358,11086,19444,206,19650,1.03709021296961,1.1091466714775393,1.0781732153877803,1.3786407766990292,1.081323155216285
Moratalaz,2013,65-84,8559,12288,20847,254,21101,8358,11086,19444,206,19650,1.0240488155061018,1.1084250405917373,1.0721559349927998,1.233009708737864,1.0738422391857507
Moratalaz,2014,65-84,8518,12294,20812,237,21049,8358,11086,19444,206,19650,1.0191433357262503,1.1089662637560889,1.0703558938490023,1.1504854368932038,1.0711959287531807
Moratalaz,2015,65-84,8429,12280,20709,217,20926,8358,11086,19444,206,19650,1.0084948552285236,1.1077034097059355,1.0650586299115408,1.0533980582524272,1.0649363867684478
Moratalaz,2016,65-84,8285,12144,20429,250,20679,8358,11086,19444,206,19650,0.9912658530748983,1.095435684647303,1.0506583007611603,1.2135922330097086,1.0523664122137404
Moratalaz,2017,65-84,8127,11987,20114,283,20397,8358,11086,19444,206,19650,0.9723618090452262,1.0812736785134405,1.034457930466982,1.3737864077669903,1.0380152671755725
Moratalaz,2004,85-100,533,1388,1921,16,1937,533,1388,1921,16,1937,1.0,1.0,1.0,1.0,1.0
Moratalaz,2005,85-100,520,1442,1962,18,1980,533,1388,1921,16,1937,0.975609756097561,1.0389048991354466,1.021343050494534,1.125,1.0221992772328343
Moratalaz,2006,85-100,541,1452,1993,22,2015,533,1388,1921,16,1937,1.0150093808630394,1.0461095100864553,1.0374804789172307,1.375,1.0402684563758389
Moratalaz,2007,85-100,628,1566,2194,20,2214,533,1388,1921,16,1937,1.1782363977485928,1.1282420749279538,1.142113482561166,1.25,1.1430046463603512
Moratalaz,2008,85-100,641,1544,2185,19,2204,533,1388,1921,16,1937,1.2026266416510318,1.1123919308357348,1.1374284226965123,1.1875,1.137842023748064
Moratalaz,2009,85-100,672,1617,2289,14,2303,533,1388,1921,16,1937,1.2607879924953096,1.164985590778098,1.191566892243623,0.875,1.1889519876097057
Moratalaz,2010,85-100,729,1689,2418,13,2431,533,1388,1921,16,1937,1.3677298311444652,1.2168587896253602,1.258719416970328,0.8125,1.25503355704698
Moratalaz,2011,85-100,781,1793,2574,16,2590,533,1388,1921,16,1937,1.4652908067542214,1.29178674351585,1.3399271212909942,1.0,1.3371192565823438
Moratalaz,2012,85-100,861,1912,2773,16,2789,533,1388,1921,16,1937,1.6153846153846154,1.377521613832853,1.4435190005205623,1.0,1.439855446566856
Moratalaz,2013,85-100,938,2050,2988,17,3005,533,1388,1921,16,1937,1.7598499061913695,1.4769452449567724,1.5554398750650702,1.0625,1.5513680949922561
Moratalaz,2014,85-100,1025,2194,3219,17,3236,533,1388,1921,16,1937,1.9230769230769231,1.580691642651297,1.6756897449245185,1.0625,1.6706246773360867
Moratalaz,2015,85-100,1132,2353,3485,19,3504,533,1388,1921,16,1937,2.123827392120075,1.6952449567723342,1.8141592920353982,1.1875,1.8089829633453796
Moratalaz,2016,85-100,1253,2561,3814,23,3837,533,1388,1921,16,1937,2.350844277673546,1.845100864553314,1.9854242581988548,1.4375,1.9808982963345378
Moratalaz,2017,85-100,1405,2752,4157,26,4183,533,1388,1921,16,1937,2.6360225140712945,1.9827089337175792,2.163977095262884,1.625,2.1595250387196696
Moratalaz,2004,Total,47403,52728,100131,8336,108467,47403,52728,100131,8336,108467,1.0,1.0,1.0,1.0,1.0
Moratalaz,2005,Total,46432,52043,98475,9139,107614,47403,52728,100131,8336,108467,0.9795160643841108,0.9870087998786223,0.9834616652185637,1.0963291746641075,0.9921358569887616
Moratalaz,2006,Total,45491,51188,96679,10451,107130,47403,52728,100131,8336,108467,0.9596650001054785,0.9707935062964649,0.9655251620377305,1.253718809980806,0.9876736703329123
Moratalaz,2007,Total,44262,50174,94436,10374,104810,47403,52728,100131,8336,108467,0.9337383709891779,0.9515627370656956,0.9431245068959663,1.2444817658349328,0.9662846764453705
Moratalaz,2008,Total,43711,49747,93458,11376,104834,47403,52728,100131,8336,108467,0.9221146340948885,0.9434645729024427,0.9333573019344659,1.36468330134357,0.9665059418993796
Moratalaz,2009,Total,43153,49283,92436,11673,104109,47403,52728,100131,8336,108467,0.9103432272219057,0.9346646942800789,0.9231506726188693,1.4003119001919386,0.9598218813095227
Moratalaz,2010,Total,42772,48946,91718,11336,103054,47403,52728,100131,8336,108467,0.9023057612387402,0.9282734031254741,0.9159800661133914,1.3598848368522074,0.9500954207270415
Moratalaz,2011,Total,42309,48534,90843,10917,101760,47403,52728,100131,8336,108467,0.8925384469337384,0.9204597177969959,0.9072415136171615,1.3096209213051824,0.9381655249983866
Moratalaz,2012,Total,41805,48233,90038,10031,100069,47403,52728,100131,8336,108467,0.8819062084678185,0.9147511758458504,0.89920204532063,1.203334932821497,0.9225755298846654
Moratalaz,2013,Total,41326,47895,89221,9112,98333,47403,52728,100131,8336,108467,0.8718013627829462,0.908340919435594,0.8910427340184358,1.0930902111324377,0.9065706620446772
Moratalaz,2014,Total,40845,47438,88283,8188,96471,47403,52728,100131,8336,108467,0.8616543256755902,0.8996737976027916,0.8816750057424774,0.9822456813819578,0.8894041505711414
Moratalaz,2015,Total,40420,47314,87734,7297,95031,47403,52728,100131,8336,108467,0.8526886483977807,0.8973221059019876,0.8761921882334143,0.8753598848368522,0.8761282233305983
Moratalaz,2016,Total,40232,47213,87445,7430,94875,47403,52728,100131,8336,108467,0.8487226546843026,0.8954066150811713,0.8733059691803737,0.8913147792706334,0.8746899978795394
Moratalaz,2017,Total,39964,46964,86928,7567,94495,47403,52728,100131,8336,108467,0.8430690040714722,0.8906842664239114,0.8681427330197441,0.9077495201535508,0.8711866281910627
Puente de Vallecas,2004,0-24,17600,16605,34205,7765,41970,17600,16605,34205,7765,41970,1.0,1.0,1.0,1.0,1.0
Puente de Vallecas,2005,0-24,16855,15807,32662,8439,41101,17600,16605,34205,7765,41970,0.9576704545454545,0.9519421860885275,0.954889636018126,1.0867997424339988,0.9792947343340481
Puente de Vallecas,2006,0-24,16166,15183,31349,8945,40294,17600,16605,34205,7765,41970,0.9185227272727273,0.9143631436314363,0.9165034351702968,1.1519639407598197,0.9600667143197522
Puente de Vallecas,2007,0-24,15516,14412,29928,8721,38649,17600,16605,34205,7765,41970,0.8815909090909091,0.8679313459801264,0.8749598011986551,1.1231165486155827,0.9208720514653324
Puente de Vallecas,2008,0-24,15254,14099,29353,10064,39417,17600,16605,34205,7765,41970,0.8667045454545454,0.8490816019271303,0.8581493933635433,1.2960721184803605,0.9391708363116512
Puente de Vallecas,2009,0-24,14835,13882,28717,10492,39209,17600,16605,34205,7765,41970,0.8428977272727273,0.8360132490213791,0.8395556205233153,1.3511912427559563,0.9342149154157732
Puente de Vallecas,2010,0-24,14682,13767,28449,9837,38286,17600,16605,34205,7765,41970,0.8342045454545455,0.8290876242095754,0.8317205086975589,1.2668383773341918,0.9122230164403146
Puente de Vallecas,2011,0-24,14692,13757,28449,8970,37419,17600,16605,34205,7765,41970,0.8347727272727272,0.8284853959650708,0.8317205086975589,1.1551835157759176,0.8915654038598999
Puente de Vallecas,2012,0-24,14738,13758,28496,7842,36338,17600,16605,34205,7765,41970,0.8373863636363637,0.8285456187895213,0.833094576816255,1.0099162910495814,0.8658089111269954
Puente de Vallecas,2013,0-24,14767,13791,28558,6889,35447,17600,16605,34205,7765,41970,0.8390340909090909,0.8305329719963866,0.8349071773132583,0.8871860914359304,0.8445794615201334
Puente de Vallecas,2014,0-24,14725,13806,28531,5968,34499,17600,16605,34205,7765,41970,0.8366477272727273,0.8314363143631436,0.8341178190323052,0.7685769478428848,0.8219918989754587
Puente de Vallecas,2015,0-24,14722,13939,28661,5429,34090,17600,16605,34205,7765,41970,0.8364772727272727,0.8394459500150557,0.8379184329776348,0.6991629104958146,0.8122468429830831
Puente de Vallecas,2016,0-24,14743,14035,28778,5489,34267,17600,16605,34205,7765,41970,0.8376704545454545,0.8452273411623005,0.8413389855284316,0.7068898905344495,0.8164641410531331
Puente de Vallecas,2017,0-24,14751,14075,28826,5615,34441,17600,16605,34205,7765,41970,0.838125,0.8476362541403192,0.8427422891390147,0.7231165486155827,0.8206099594948773
Puente de Vallecas,2004,25-39,25540,24785,50325,14561,64886,25540,24785,50325,14561,64886,1.0,1.0,1.0,1.0,1.0
Puente de Vallecas,2005,25-39,24145,23643,47788,17293,65081,25540,24785,50325,14561,64886,0.9453797963978073,0.953923744200121,0.9495876800794834,1.1876244763409107,1.0030052707826034
Puente de Vallecas,2006,25-39,23056,22460,45516,19886,65402,25540,24785,50325,14561,64886,0.9027407987470635,0.9061932620536615,0.904441132637854,1.3657029050202596,1.0079524088401195
Puente de Vallecas,2007,25-39,21335,20858,42193,20478,62671,25540,24785,50325,14561,64886,0.8353563038371182,0.8415573935848295,0.8384103328365623,1.406359453334249,0.9658632062386339
Puente de Vallecas,2008,25-39,20918,20504,41422,22290,63712,25540,24785,50325,14561,64886,0.8190289741581832,0.8272745612265483,0.823089915548932,1.53080145594396,0.981906728724224
Puente de Vallecas,2009,25-39,20206,19845,40051,23321,63372,25540,24785,50325,14561,64886,0.7911511354737666,0.80068589872907,0.7958469945355191,1.6016070324840328,0.976666769410967
Puente de Vallecas,2010,25-39,19571,19295,38866,22926,61792,25540,24785,50325,14561,64886,0.7662881754111198,0.7784950574944522,0.7723000496770989,1.5744797747407457,0.9523163702493604
Puente de Vallecas,2011,25-39,19057,18721,37778,21834,59612,25540,24785,50325,14561,64886,0.7461628817541112,0.755335888642324,0.7506805762543467,1.4994849254858869,0.918718984064359
Puente de Vallecas,2012,25-39,18523,18400,36923,19863,56786,25540,24785,50325,14561,64886,0.7252545027407987,0.7423845067581198,0.7336910084451068,1.3641233431769797,0.8751656751841692
Puente de Vallecas,2013,25-39,18163,17914,36077,17411,53488,25540,24785,50325,14561,64886,0.7111589663273297,0.7227758725035304,0.7168802781917536,1.1957283153629559,0.8243380698455753
Puente de Vallecas,2014,25-39,17905,17673,35578,15167,50745,25540,24785,50325,14561,64886,0.7010571652310101,0.7130522493443615,0.7069647292598112,1.0416180207403338,0.7820639275036217
Puente de Vallecas,2015,25-39,17648,17497,35145,13298,48443,25540,24785,50325,14561,64886,0.6909945184025059,0.7059511801492838,0.6983606557377049,0.9132614518233638,0.7465863206238634
Puente de Vallecas,2016,25-39,17450,17330,34780,13245,48025,25540,24785,50325,14561,64886,0.6832419733750978,0.6992132338107726,0.6911077993045206,0.9096215919236316,0.7401442529975649
Puente de Vallecas,2017,25-39,17141,16978,34119,13470,47589,25540,24785,50325,14561,64886,0.6711433046202036,0.6850110954206173,0.677973174366617,0.9250738273470228,0.7334247757605646
Puente de Vallecas,2004,40-64,29954,32203,62157,6018,68175,29954,32203,62157,6018,68175,1.0,1.0,1.0,1.0,1.0
Puente de Vallecas,2005,40-64,30544,32735,63279,7311,70590,29954,32203,62157,6018,68175,1.0196968685317487,1.0165201999813682,1.0180510642405523,1.2148554336989033,1.0354235423542355
Puente de Vallecas,2006,40-64,30773,32898,63671,8681,72352,29954,32203,62157,6018,68175,1.027341924283902,1.0215818402012236,1.0243576749199608,1.4425058158856763,1.0612687935460212
Puente de Vallecas,2007,40-64,31344,33707,65051,9205,74256,29954,32203,62157,6018,68175,1.0464044868798825,1.0467037232555974,1.046559518638287,1.5295779328680625,1.0891969196919693
Puente de Vallecas,2008,40-64,31507,34009,65516,9759,75275,29954,32203,62157,6018,68175,1.0518461641183148,1.0560817315156974,1.05404057467381,1.6216350947158524,1.1041437477081042
Puente de Vallecas,2009,40-64,31781,34335,66116,10782,76898,29954,32203,62157,6018,68175,1.0609935234025505,1.0662050119554078,1.063693550203517,1.7916251246261217,1.127950128346168
Puente de Vallecas,2010,40-64,32184,34770,66954,11260,78214,29954,32203,62157,6018,68175,1.074447486145423,1.07971307021085,1.0771755393600078,1.871053506148222,1.1472533920058672
Puente de Vallecas,2011,40-64,32439,35074,67513,11661,79174,29954,32203,62157,6018,68175,1.0829605394938906,1.0891531844859175,1.0861688948951849,1.9376869391824527,1.1613348001466814
Puente de Vallecas,2012,40-64,32840,35680,68520,11270,79790,29954,32203,62157,6018,68175,1.0963477331908926,1.107971307021085,1.102369805492543,1.8727151877700232,1.1703703703703703
Puente de Vallecas,2013,40-64,33392,36271,69663,10744,80407,29954,32203,62157,6018,68175,1.114775989851105,1.126323634443996,1.120758723876635,1.7853107344632768,1.1794206087275394
Puente de Vallecas,2014,40-64,33611,36522,70133,10138,80271,29954,32203,62157,6018,68175,1.1220872003739066,1.1341179393224234,1.1283202213749055,1.6846128281821202,1.1774257425742574
Puente de Vallecas,2015,40-64,34092,37216,71308,9791,81099,29954,32203,62157,6018,68175,1.138145155905722,1.1556687265161631,1.1472239651205818,1.6269524759056164,1.1895709570957096
Puente de Vallecas,2016,40-64,34546,37743,72289,10418,82707,29954,32203,62157,6018,68175,1.1533017293182881,1.1720336614601123,1.1630065801116527,1.7311399135925556,1.2131573157315731
Puente de Vallecas,2017,40-64,34807,38212,73019,10965,83984,29954,32203,62157,6018,68175,1.1620150898043666,1.186597521970003,1.1747510336727962,1.8220338983050848,1.2318885221855518
Puente de Vallecas,2004,65-84,16806,23909,40715,420,41135,16806,23909,40715,420,41135,1.0,1.0,1.0,1.0,1.0
Puente de Vallecas,2005,65-84,16385,23589,39974,516,40490,16806,23909,40715,420,41135,0.9749494228251815,0.9866159186917061,0.981800319292644,1.2285714285714286,0.984319922207366
Puente de Vallecas,2006,65-84,16234,23618,39852,620,40472,16806,23909,40715,420,41135,0.9659645364750684,0.9878288510602702,0.9788038806336731,1.4761904761904763,0.9838823386410599
Puente de Vallecas,2007,65-84,15853,23044,38897,505,39402,16806,23909,40715,420,41135,0.9432940616446507,0.963821155213518,0.9553481517868108,1.2023809523809523,0.9578704266439771
Puente de Vallecas,2008,65-84,15496,22696,38192,496,38688,16806,23909,40715,420,41135,0.9220516482208735,0.9492659667907483,0.9380326660935773,1.180952380952381,0.9405129451805032
Puente de Vallecas,2009,65-84,15279,22445,37724,503,38227,16806,23909,40715,420,41135,0.9091395930024991,0.9387678280145552,0.926538130909984,1.1976190476190476,0.9293059438434423
Puente de Vallecas,2010,65-84,15107,22270,37377,522,37899,16806,23909,40715,420,41135,0.8989051529215756,0.931448408549082,0.9180154734127471,1.2428571428571429,0.9213321988574207
Puente de Vallecas,2011,65-84,14923,22046,36969,574,37543,16806,23909,40715,420,41135,0.8879566821373319,0.9220795516332762,0.9079945965860248,1.3666666666666667,0.9126777683238119
Puente de Vallecas,2012,65-84,14649,21657,36306,568,36874,16806,23909,40715,420,41135,0.8716529810781863,0.9058095277928814,0.891710671742601,1.3523809523809525,0.8964142457761031
Puente de Vallecas,2013,65-84,14453,21287,35740,578,36318,16806,23909,40715,420,41135,0.8599904795906224,0.8903341837801665,0.8778091612427852,1.3761904761904762,0.8828977756168713
Puente de Vallecas,2014,65-84,14353,20971,35324,575,35899,16806,23909,40715,420,41135,0.8540402237296204,0.8771174034882262,0.8675917966351467,1.369047619047619,0.8727118026011912
Puente de Vallecas,2015,65-84,14112,20582,34694,577,35271,16806,23909,40715,420,41135,0.8397001071046055,0.8608473796478313,0.852118383888002,1.3738095238095238,0.8574449981767351
Puente de Vallecas,2016,65-84,13825,20106,33931,671,34602,16806,23909,40715,420,41135,0.8226228727835297,0.8409385587017442,0.8333783617831266,1.5976190476190477,0.8411814756290263
Puente de Vallecas,2017,65-84,13594,19612,33206,790,33996,16806,23909,40715,420,41135,0.808877781744615,0.8202768831820654,0.8155716566376029,1.880952380952381,0.8264494955633889
Puente de Vallecas,2004,85-100,1124,2952,4076,28,4104,1124,2952,4076,28,4104,1.0,1.0,1.0,1.0,1.0
Puente de Vallecas,2005,85-100,1138,3012,4150,34,4184,1124,2952,4076,28,4104,1.0124555160142348,1.0203252032520325,1.0181550539744848,1.2142857142857142,1.0194931773879143
Puente de Vallecas,2006,85-100,1224,3131,4355,35,4390,1124,2952,4076,28,4104,1.0889679715302492,1.0606368563685638,1.0684494602551522,1.25,1.0696881091617934
Puente de Vallecas,2007,85-100,1475,3511,4986,25,5011,1124,2952,4076,28,4104,1.3122775800711743,1.1893631436314362,1.2232580961727184,0.8928571428571429,1.2210038986354776
Puente de Vallecas,2008,85-100,1428,3446,4874,23,4897,1124,2952,4076,28,4104,1.2704626334519573,1.1673441734417345,1.1957801766437683,0.8214285714285714,1.1932261208576997
Puente de Vallecas,2009,85-100,1519,3613,5132,27,5159,1124,2952,4076,28,4104,1.351423487544484,1.2239159891598916,1.2590775269872423,0.9642857142857143,1.2570662768031189
Puente de Vallecas,2010,85-100,1660,3943,5603,33,5636,1124,2952,4076,28,4104,1.4768683274021353,1.3357046070460705,1.3746319921491659,1.1785714285714286,1.3732943469785575
Puente de Vallecas,2011,85-100,1803,4150,5953,30,5983,1124,2952,4076,28,4104,1.6040925266903914,1.4058265582655827,1.4605004906771344,1.0714285714285714,1.4578460038986354
Puente de Vallecas,2012,85-100,1928,4390,6318,21,6339,1124,2952,4076,28,4104,1.7153024911032029,1.4871273712737128,1.5500490677134446,0.75,1.5445906432748537
Puente de Vallecas,2013,85-100,2063,4649,6712,20,6732,1124,2952,4076,28,4104,1.835409252669039,1.5748644986449865,1.646712463199215,0.7142857142857143,1.6403508771929824
Puente de Vallecas,2014,85-100,2252,4960,7212,21,7233,1124,2952,4076,28,4104,2.00355871886121,1.6802168021680217,1.7693817468105986,0.75,1.7624269005847952
Puente de Vallecas,2015,85-100,2400,5174,7574,25,7599,1124,2952,4076,28,4104,2.1352313167259784,1.752710027100271,1.8581943081452403,0.8928571428571429,1.851608187134503
Puente de Vallecas,2016,85-100,2561,5400,7961,26,7987,1124,2952,4076,28,4104,2.2784697508896796,1.829268292682927,1.9531403336604514,0.9285714285714286,1.946150097465887
Puente de Vallecas,2017,85-100,2670,5585,8255,31,8286,1124,2952,4076,28,4104,2.3754448398576513,1.8919376693766938,2.025269872423945,1.1071428571428572,2.0190058479532165
Puente de Vallecas,2004,Total,100581,109549,210130,32258,242388,100581,109549,210130,32258,242388,1.0,1.0,1.0,1.0,1.0
Puente de Vallecas,2005,Total,98697,107833,206530,37416,243946,100581,109549,210130,32258,242388,0.9812688281086885,0.9843357766844061,0.9828677485366202,1.1598983197966395,1.006427710942786
Puente de Vallecas,2006,Total,97047,106372,203419,42308,245727,100581,109549,210130,32258,242388,0.9648641393503743,0.970999278861514,0.9680626278970161,1.3115506231012461,1.013775434427447
Puente de Vallecas,2007,Total,94835,104244,199079,42749,241828,100581,109549,210130,32258,242388,0.9428719141786222,0.951574181416535,0.9474087469661638,1.325221650443301,0.9976896546033632
Puente de Vallecas,2008,Total,94195,103835,198030,46926,244956,100581,109549,210130,32258,242388,0.9365088833875185,0.9478406922929465,0.9424165992480845,1.454708909417819,1.0105945838902917
Puente de Vallecas,2009,Total,93358,103305,196663,49605,246268,100581,109549,210130,32258,242388,0.9281872321810283,0.9430026746022327,0.9359111026507401,1.537758075516151,1.0160073931052693
Puente de Vallecas,2010,Total,92950,103223,196173,48930,245103,100581,109549,210130,32258,242388,0.9241308000516997,0.942254151110462,0.9335792128682244,1.5168330336660674,1.0112010495569088
Puente de Vallecas,2011,Total,92604,102749,195353,47348,242701,100581,109549,210130,32258,242388,0.9206907865302592,0.9379273201946161,0.9296768667015657,1.4677909355818712,1.0012913180520489
Puente de Vallecas,2012,Total,92144,102650,194794,43659,238453,100581,109549,210130,32258,242388,0.9161173581491534,0.9370236150033319,0.927016608766002,1.3534317068634136,0.9837656979718468
Puente de Vallecas,2013,Total,92055,102442,194497,39662,234159,100581,109549,210130,32258,242388,0.9152324991797656,0.9351249212681083,0.9256031980202731,1.229524459048918,0.9660502995197782
Puente de Vallecas,2014,Total,91731,102156,193887,35621,229508,100581,109549,210130,32258,242388,0.9120112148417693,0.932514217382176,0.9227002331889782,1.104253208506417,0.9468620558773536
Puente de Vallecas,2015,Total,91665,102527,194192,32552,226744,100581,109549,210130,32258,242388,0.9113550272914368,0.9359008297656757,0.9241517156046257,1.0091140182280365,0.9354588510982392
Puente de Vallecas,2016,Total,91815,102705,194520,33332,227852,100581,109549,210130,32258,242388,0.9128463626331017,0.9375256734429342,0.9257126540712892,1.0332940665881332,0.9400300344901563
Puente de Vallecas,2017,Total,91475,102364,193839,34410,228249,100581,109549,210130,32258,242388,0.9094660025253278,0.9344129111173995,0.9224718031694665,1.0667121334242669,0.9416679043517006
Retiro,2004,0-24,8608,8411,17019,2139,19158,8608,8411,17019,2139,19158,1.0,1.0,1.0,1.0,1.0
Retiro,2005,0-24,8195,8079,16274,2117,18391,8608,8411,17019,2139,19158,0.952021375464684,0.9605278801569374,0.9562253951466009,0.9897148200093502,0.9599645056895292
Retiro,2006,0-24,7862,7695,15557,2135,17692,8608,8411,17019,2139,19158,0.9133364312267658,0.9148733800974914,0.9140960103413832,0.9981299672744273,0.9234784424261405
Retiro,2007,0-24,7349,7276,14625,1767,16392,8608,8411,17019,2139,19158,0.8537407063197026,0.8650576625847105,0.8593336858804865,0.8260869565217391,0.8556216724083934
Retiro,2008,0-24,7249,7172,14421,1979,16400,8608,8411,17019,2139,19158,0.8421236059479554,0.8526929021519439,0.8473470826723074,0.9251986909770921,0.8560392525315795
Retiro,2009,0-24,7040,7010,14050,1969,16019,8608,8411,17019,2139,19158,0.8178438661710037,0.8334324099393651,0.8255479170339033,0.9205236091631603,0.8361519991648397
Retiro,2010,0-24,6828,6837,13665,1693,15358,8608,8411,17019,2139,19158,0.7932156133828996,0.8128641065271668,0.8029261413714084,0.7914913510986442,0.8016494414865852
Retiro,2011,0-24,6766,6630,13396,1462,14858,8608,8411,17019,2139,19158,0.7860130111524164,0.7882534775888718,0.7871202773370939,0.6834969611968209,0.7755506837874517
Retiro,2012,0-24,6689,6518,13207,1334,14541,8608,8411,17019,2139,19158,0.777067843866171,0.7749375817381999,0.7760150420118691,0.6236559139784946,0.7590040714062011
Retiro,2013,0-24,6610,6457,13067,1241,14308,8608,8411,17019,2139,19158,0.7678903345724907,0.7676851741766734,0.7677889417709619,0.5801776531089294,0.7468420503184049
Retiro,2014,0-24,6510,6358,12868,1097,13965,8608,8411,17019,2139,19158,0.7562732342007435,0.7559148733800974,0.7560961278571009,0.5128564749883123,0.7289383025367993
Retiro,2015,0-24,6518,6364,12882,1007,13889,8608,8411,17019,2139,19158,0.7572026022304833,0.7566282249435263,0.7569187378811916,0.4707807386629266,0.7249712913665309
Retiro,2016,0-24,6540,6460,13000,1010,14010,8608,8411,17019,2139,19158,0.7597583643122676,0.7680418499583879,0.7638521652270991,0.47218326320710613,0.7312871907297213
Retiro,2017,0-24,6555,6448,13003,915,13918,8608,8411,17019,2139,19158,0.7615009293680297,0.7666151468315301,0.76402843880369,0.4277699859747546,0.7264850193130807
Retiro,2004,25-39,13019,12953,25972,5072,31044,13019,12953,25972,5072,31044,1.0,1.0,1.0,1.0,1.0
Retiro,2005,25-39,12785,12688,25473,5675,31148,13019,12953,25972,5072,31044,0.9820262692987173,0.9795414189762989,0.9807870013861081,1.1188880126182965,1.003350083752094
Retiro,2006,25-39,12473,12278,24751,6184,30935,13019,12953,25972,5072,31044,0.9580612950303403,0.947888520033969,0.952987833050978,1.2192429022082019,0.9964888545290556
Retiro,2007,25-39,12006,11887,23893,5521,29414,13019,12953,25972,5072,31044,0.9221906444427376,0.917702462749942,0.9199522562759895,1.08852523659306,0.9474938796546837
Retiro,2008,25-39,11784,11818,23602,5660,29262,13019,12953,25972,5072,31044,0.9051386435210078,0.9123755114645256,0.9087478823348221,1.1159305993690851,0.9425976034016235
Retiro,2009,25-39,11546,11638,23184,5889,29073,13019,12953,25972,5072,31044,0.886857669559874,0.8984791168069173,0.8926536269829046,1.1610804416403786,0.9365094704290684
Retiro,2010,25-39,11460,11482,22942,5721,28663,13019,12953,25972,5072,31044,0.8802519394730778,0.8864355747703235,0.8833359002002156,1.1279574132492114,0.923302409483314
Retiro,2011,25-39,11232,11389,22621,5542,28163,13019,12953,25972,5072,31044,0.8627390736615715,0.8792557708638925,0.8709764361620206,1.0926656151419558,0.9071962375982476
Retiro,2012,25-39,11088,11239,22327,4879,27206,13019,12953,25972,5072,31044,0.851678316306936,0.8676754419825523,0.8596565532111504,0.9619479495268138,0.8763690246102307
Retiro,2013,25-39,10836,11007,21843,4452,26295,13019,12953,25972,5072,31044,0.8323219909363239,0.849764533312746,0.8410210996457723,0.8777602523659306,0.8470235794356398
Retiro,2014,25-39,10518,10769,21287,3954,25241,13019,12953,25972,5072,31044,0.8078961517781703,0.8313904114876862,0.819613429847528,0.7795741324921136,0.8130717691019198
Retiro,2015,25-39,10266,10564,20830,3441,24271,13019,12953,25972,5072,31044,0.7885398264075582,0.8155639620165213,0.8020175573694748,0.6784305993690851,0.7818257956448911
Retiro,2016,25-39,10044,10326,20370,3510,23880,13019,12953,25972,5072,31044,0.7714878254858284,0.7971898401914614,0.7843061758817188,0.6920347003154574,0.7692307692307693
Retiro,2017,25-39,9809,10042,19851,3478,23329,13019,12953,25972,5072,31044,0.7534372839695829,0.7752644175094573,0.7643231172031418,0.6857255520504731,0.7514817678134261
Retiro,2004,40-64,17415,21704,39119,2695,41814,17415,21704,39119,2695,41814,1.0,1.0,1.0,1.0,1.0
Retiro,2005,40-64,17755,21946,39701,3070,42771,17415,21704,39119,2695,41814,1.0195233993683606,1.0111500184297826,1.014877680922314,1.1391465677179964,1.0228870713158273
Retiro,2006,40-64,17730,21850,39580,3434,43014,17415,21704,39119,2695,41814,1.0180878552971577,1.0067268706229267,1.0117845548199085,1.2742115027829313,1.0286985220261156
Retiro,2007,40-64,17920,21896,39816,3098,42914,17415,21704,39119,2695,41814,1.0289979902383004,1.0088462956137119,1.0178174288708812,1.1495361781076068,1.0263069785239394
Retiro,2008,40-64,17981,21891,39872,3244,43116,17415,21704,39119,2695,41814,1.0325007177720356,1.0086159233321046,1.0192489583067053,1.2037105751391466,1.0311378963983355
Retiro,2009,40-64,17874,21862,39736,3406,43142,17415,21704,39119,2695,41814,1.0263565891472868,1.0072797640987836,1.015772386819704,1.2638218923933209,1.0317596977089014
Retiro,2010,40-64,17802,21759,39561,3458,43019,17415,21704,39119,2695,41814,1.0222222222222221,1.0025340950976778,1.011298857332754,1.283116883116883,1.0288180992012246
Retiro,2011,40-64,17764,21588,39352,3439,42791,17415,21704,39119,2695,41814,1.0200401952339937,0.9946553630667158,1.0059561849740535,1.2760667903525047,1.0233653800162625
Retiro,2012,40-64,17793,21537,39330,3157,42487,17415,21704,39119,2695,41814,1.0217054263565892,0.9923055657943236,1.0053937984099799,1.1714285714285715,1.0160950877696466
Retiro,2013,40-64,17808,21409,39217,3015,42232,17415,21704,39119,2695,41814,1.022566752799311,0.9864080353851824,1.002505176512692,1.1187384044526902,1.009996651839097
Retiro,2014,40-64,17726,21258,38984,2723,41707,17415,21704,39119,2695,41814,1.0178581682457652,0.9794507924806487,0.9965489915386385,1.0103896103896104,0.9974410484526713
Retiro,2015,40-64,17776,21179,38955,2560,41515,17415,21704,39119,2695,41814,1.0207292563881711,0.9758109104312569,0.9958076637950868,0.9499072356215214,0.9928492849284929
Retiro,2016,40-64,17947,21272,39219,2586,41805,17415,21704,39119,2695,41814,1.0305483778351996,0.9800958348691485,1.0025563025639714,0.9595547309833025,0.9997847610848042
Retiro,2017,40-64,18058,21218,39276,2690,41966,17415,21704,39119,2695,41814,1.0369221935113409,0.9776078142277921,1.0040133950254353,0.9981447124304267,1.003635146123308
Retiro,2004,65-84,8413,13235,21648,357,22005,8413,13235,21648,357,22005,1.0,1.0,1.0,1.0,1.0
Retiro,2005,65-84,8298,13060,21358,406,21764,8413,13235,21648,357,22005,0.9863306787115179,0.9867774839440876,0.9866038433111604,1.1372549019607843,0.9890479436491706
Retiro,2006,65-84,8449,13149,21598,465,22063,8413,13235,21648,357,22005,1.0042790918816118,0.9935020778239516,0.997690317812269,1.3025210084033614,1.0026357645989548
Retiro,2007,65-84,8610,13180,21790,386,22176,8413,13235,21648,357,22005,1.0234161416854868,0.9958443520967133,1.006559497413156,1.0812324929971988,1.0077709611451944
Retiro,2008,65-84,8622,13147,21769,375,22144,8413,13235,21648,357,22005,1.024842505646024,0.9933509633547413,1.005589430894309,1.050420168067227,1.0063167461940468
Retiro,2009,65-84,8768,13185,21953,374,22327,8413,13235,21648,357,22005,1.0421966004992274,0.9962221382697394,1.014089061345159,1.0476190476190477,1.0146330379459214
Retiro,2010,65-84,8905,13275,22180,405,22585,8413,13235,21648,357,22005,1.0584809223820277,1.0030222893842085,1.0245750184774576,1.134453781512605,1.0263576459895478
Retiro,2011,65-84,9016,13411,22427,401,22828,8413,13235,21648,357,22005,1.0716747890169975,1.0132980732905175,1.0359848484848484,1.123249299719888,1.0374005907748238
Retiro,2012,65-84,9076,13511,22587,367,22954,8413,13235,21648,357,22005,1.078806608819684,1.020853796751039,1.0433758314855877,1.0280112044817926,1.043126562144967
Retiro,2013,65-84,9240,13704,22944,372,23316,8413,13235,21648,357,22005,1.098300249613693,1.0354363430298452,1.0598669623059866,1.0420168067226891,1.0595773687798227
Retiro,2014,65-84,9411,13829,23240,382,23622,8413,13235,21648,357,22005,1.118625936051349,1.0448809973554969,1.073540280857354,1.0700280112044818,1.0734832992501704
Retiro,2015,65-84,9509,13915,23424,387,23811,8413,13235,21648,357,22005,1.1302745750624035,1.051378919531545,1.082039911308204,1.084033613445378,1.082072256305385
Retiro,2016,65-84,9636,13995,23631,405,24036,8413,13235,21648,357,22005,1.1453702603114229,1.0574234982999622,1.0916019955654102,1.134453781512605,1.0922972051806408
Retiro,2017,65-84,9800,14120,23920,417,24337,8413,13235,21648,357,22005,1.164863901105432,1.0668681526256139,1.1049519586104952,1.1680672268907564,1.1059759145648715
Retiro,2004,85-100,982,2640,3622,62,3684,982,2640,3622,62,3684,1.0,1.0,1.0,1.0,1.0
Retiro,2005,85-100,995,2664,3659,60,3719,982,2640,3622,62,3684,1.0132382892057026,1.009090909090909,1.0102153506350082,0.967741935483871,1.009500542888165
Retiro,2006,85-100,1007,2757,3764,66,3830,982,2640,3622,62,3684,1.025458248472505,1.044318181818182,1.0392048591938157,1.064516129032258,1.0396308360477742
Retiro,2007,85-100,1125,2998,4123,45,4168,982,2640,3622,62,3684,1.145621181262729,1.1356060606060605,1.1383213694091663,0.7258064516129032,1.1313789359391966
Retiro,2008,85-100,1142,3008,4150,46,4196,982,2640,3622,62,3684,1.1629327902240325,1.1393939393939394,1.1457758144671453,0.7419354838709677,1.1389793702497286
Retiro,2009,85-100,1173,3120,4293,52,4345,982,2640,3622,62,3684,1.194501018329939,1.1818181818181819,1.1852567642186638,0.8387096774193549,1.1794245385450597
Retiro,2010,85-100,1239,3252,4491,54,4545,982,2640,3622,62,3684,1.2617107942973524,1.231818181818182,1.239922694643843,0.8709677419354839,1.23371335504886
Retiro,2011,85-100,1323,3331,4654,49,4703,982,2640,3622,62,3684,1.3472505091649694,1.2617424242424242,1.2849254555494203,0.7903225806451613,1.2766015200868621
Retiro,2012,85-100,1370,3477,4847,46,4893,982,2640,3622,62,3684,1.395112016293279,1.3170454545454546,1.338210933186085,0.7419354838709677,1.3281758957654723
Retiro,2013,85-100,1405,3598,5003,46,5049,982,2640,3622,62,3684,1.4307535641547862,1.3628787878787878,1.3812810601877417,0.7419354838709677,1.3705211726384365
Retiro,2014,85-100,1457,3744,5201,39,5240,982,2640,3622,62,3684,1.4837067209775967,1.4181818181818182,1.435946990612921,0.6290322580645161,1.4223669923995657
Retiro,2015,85-100,1538,3869,5407,33,5440,982,2640,3622,62,3684,1.5661914460285133,1.465530303030303,1.4928216454997238,0.532258064516129,1.476655808903366
Retiro,2016,85-100,1605,3984,5589,40,5629,982,2640,3622,62,3684,1.6344195519348268,1.509090909090909,1.5430701270016565,0.6451612903225806,1.527958740499457
Retiro,2017,85-100,1667,4091,5758,42,5800,982,2640,3622,62,3684,1.6975560081466394,1.549621212121212,1.5897294312534511,0.6774193548387096,1.5743756786102063
Retiro,2004,Total,52812,63076,115888,11192,127080,52812,63076,115888,11192,127080,1.0,1.0,1.0,1.0,1.0
Retiro,2005,Total,52481,62662,115143,12198,127341,52812,63076,115888,11192,127080,0.9937324850412785,0.9934364893144778,0.9935713792627364,1.0898856325947106,1.0020538243626063
Retiro,2006,Total,52051,62008,114059,13143,127202,52812,63076,115888,11192,127080,0.9855903961220934,0.983068044898218,0.9842175203644898,1.1743209435310937,1.0009600251809883
Retiro,2007,Total,51465,61418,112883,11547,124430,52812,63076,115888,11192,127080,0.9744944330833901,0.9737142494768216,0.9740697915228497,1.0317190850607576,0.9791469940195152
Retiro,2008,Total,51307,61327,112634,12069,124703,52812,63076,115888,11192,127080,0.9715026887828524,0.9722715454372503,0.9719211652630125,1.078359542530379,0.9812952470884482
Retiro,2009,Total,50904,61163,112067,12463,124530,52812,63076,115888,11192,127080,0.9638718473074301,0.969671507387913,0.9670285102857932,1.1135632594710507,0.9799338999055713
Retiro,2010,Total,50723,60969,111692,12076,123768,52812,63076,115888,11192,127080,0.9604445959251685,0.9665958526222335,0.9637926273643518,1.0789849892780559,0.9739376770538244
Retiro,2011,Total,50604,60748,111352,11593,122945,52812,63076,115888,11192,127080,0.9581913201545104,0.9630921428118461,0.9608587601822449,1.0358291636883488,0.9674614416115832
Retiro,2012,Total,50521,60614,111135,10413,121548,52812,63076,115888,11192,127080,0.9566197076422025,0.9609677214788509,0.9589862625983708,0.9303967119370979,0.9564683663833805
Retiro,2013,Total,50368,60547,110915,9756,120671,52812,63076,115888,11192,127080,0.9537226387942135,0.9599055108123533,0.9570878779511253,0.8716940671908506,0.9495672017626692
Retiro,2014,Total,50107,60293,110400,8748,119148,52812,63076,115888,11192,127080,0.9487805801711732,0.9558786226139895,0.9526439320723458,0.7816297355253753,0.9375826251180359
Retiro,2015,Total,50050,60253,110303,7909,118212,52812,63076,115888,11192,127080,0.9477012800121185,0.9552444669921999,0.9518069170233329,0.7066654753395283,0.9302171860245515
Retiro,2016,Total,50273,60508,110781,8050,118831,52812,63076,115888,11192,127080,0.9519238051957888,0.9592872090811085,0.9559315891205301,0.7192637598284489,0.9350881334592382
Retiro,2017,Total,50423,60368,110791,8053,118844,52812,63076,115888,11192,127080,0.9547640687722487,0.9570676644048449,0.9560178793317686,0.7195318084345962,0.9351904312244256
Salamanca,2004,0-24,8380,8249,16629,3581,20210,8380,8249,16629,3581,20210,1.0,1.0,1.0,1.0,1.0
Salamanca,2005,0-24,8082,7928,16010,3508,19518,8380,8249,16629,3581,20210,0.9644391408114559,0.9610861922657292,0.9627758734740514,0.9796146327841385,0.9657595249876298
Salamanca,2006,0-24,7858,7672,15530,3550,19080,8380,8249,16629,3581,20210,0.9377088305489261,0.9300521275306097,0.9339106380419748,0.9913432002234013,0.9440870856011875
Salamanca,2007,0-24,7493,7356,14849,2737,17586,8380,8249,16629,3581,20210,0.8941527446300715,0.8917444538731968,0.8929580852727164,0.7643116447919576,0.8701632855022267
Salamanca,2008,0-24,7509,7368,14877,2988,17865,8380,8249,16629,3581,20210,0.8960620525059666,0.8931991756576555,0.8946418906729208,0.8344037978218375,0.883968332508659
Salamanca,2009,0-24,7448,7279,14727,2957,17684,8380,8249,16629,3581,20210,0.8887828162291169,0.8824099890895866,0.8856215046003969,0.8257469980452388,0.8750123701138051
Salamanca,2010,0-24,7331,7213,14544,2727,17271,8380,8249,16629,3581,20210,0.8748210023866348,0.8744090192750636,0.8746166335919178,0.7615191287349903,0.8545769421078674
Salamanca,2011,0-24,7297,7090,14387,2533,16920,8380,8249,16629,3581,20210,0.870763723150358,0.8594981209843617,0.8651752961693427,0.707344317229824,0.8372093023255814
Salamanca,2012,0-24,7260,7181,14441,2206,16647,8380,8249,16629,3581,20210,0.8663484486873508,0.8705297611831737,0.8684226351554514,0.6160290421669925,0.8237011380504701
Salamanca,2013,0-24,7186,7115,14301,2140,16441,8380,8249,16629,3581,20210,0.8575178997613365,0.8625287913686508,0.860003608154429,0.597598436191008,0.8135081642751113
Salamanca,2014,0-24,7107,7066,14173,2075,16248,8380,8249,16629,3581,20210,0.848090692124105,0.8565886774154443,0.8523062120392086,0.5794470818207205,0.803958436417615
Salamanca,2015,0-24,7117,7070,14187,2088,16275,8380,8249,16629,3581,20210,0.8492840095465394,0.8570735846769305,0.8531481147393108,0.583077352694778,0.8052944087085602
Salamanca,2016,0-24,7154,7095,14249,2109,16358,8380,8249,16629,3581,20210,0.8536992840095465,0.8601042550612196,0.8568765409826207,0.5889416364144093,0.8094012864918357
Salamanca,2017,0-24,7198,7194,14392,2257,16649,8380,8249,16629,3581,20210,0.8589498806682577,0.872105709783004,0.8654759757050935,0.6302708740575258,0.8238000989609104
Salamanca,2004,25-39,14747,15334,30081,9268,39349,14747,15334,30081,9268,39349,1.0,1.0,1.0,1.0,1.0
Salamanca,2005,25-39,14436,14984,29420,9981,39401,14747,15334,30081,9268,39349,0.9789109649420221,0.977174905438894,0.9780259964761809,1.0769313767803195,1.0013215075351343
Salamanca,2006,25-39,13941,14528,28469,10831,39300,14747,15334,30081,9268,39349,0.9453448158947583,0.9474370679535672,0.9464113560054519,1.168644799309452,0.9987547332842004
Salamanca,2007,25-39,13127,13651,26778,9286,36064,14747,15334,30081,9268,39349,0.890147148572591,0.8902439024390244,0.8901964695322628,1.0019421665947346,0.9165163028285344
Salamanca,2008,25-39,13200,13885,27085,9756,36841,14747,15334,30081,9268,39349,0.895097307927036,0.905504108517021,0.9004022472657159,1.0526542943461372,0.9362626750362144
Salamanca,2009,25-39,12988,13790,26778,10076,36854,14747,15334,30081,9268,39349,0.8807215026785109,0.8993087257075779,0.8901964695322628,1.087181700474752,0.936593051919998
Salamanca,2010,25-39,12760,13685,26445,10078,36523,14747,15334,30081,9268,39349,0.8652607309961348,0.8924611973392461,0.8791263588311559,1.0873974967630557,0.9281811481867391
Salamanca,2011,25-39,12662,13869,26531,9906,36437,14747,15334,30081,9268,39349,0.8586153115887977,0.904460675622799,0.8819853063395499,1.0688390159689254,0.9259955780324786
Salamanca,2012,25-39,12674,13632,26306,9369,35675,14747,15334,30081,9268,39349,0.8594290364141859,0.8890048258771358,0.8745055018117749,1.010897712559344,0.9066304099214719
Salamanca,2013,25-39,12534,13600,26134,9156,35290,14747,15334,30081,9268,39349,0.8499355801179901,0.8869179600886918,0.8687876067949869,0.9879154078549849,0.8968461714401891
Salamanca,2014,25-39,12293,13316,25609,8417,34026,14747,15334,30081,9268,39349,0.8335932732081102,0.8683970262162515,0.8513347295635119,0.9081786793267156,0.8647233728938474
Salamanca,2015,25-39,12191,13170,25361,7690,33051,14747,15334,30081,9268,39349,0.8266766121923103,0.8588757010564758,0.8430903227951199,0.8297367285282693,0.839945106610079
Salamanca,2016,25-39,12161,13123,25284,8096,33380,14747,15334,30081,9268,39349,0.8246423001288398,0.8558106169296987,0.8405305674678368,0.8735433750539491,0.848306183130448
Salamanca,2017,25-39,11991,13031,25022,8223,33245,14747,15334,30081,9268,39349,0.8131145317691734,0.8498108777879223,0.8318207506399389,0.887246439361243,0.8448753462603878
Salamanca,2004,40-64,18630,23836,42466,4869,47335,18630,23836,42466,4869,47335,1.0,1.0,1.0,1.0,1.0
Salamanca,2005,40-64,19119,24185,43304,5547,48851,18630,23836,42466,4869,47335,1.0262479871175523,1.014641718409129,1.0197334338058681,1.1392483056069007,1.0320270413013626
Salamanca,2006,40-64,19173,24120,43293,6298,49591,18630,23836,42466,4869,47335,1.02914653784219,1.0119147507971136,1.0194744030518532,1.2934894228794414,1.047660293651632
Salamanca,2007,40-64,19004,23947,42951,5591,48542,18630,23836,42466,4869,47335,1.0200751476113794,1.0046568216143648,1.011420901427024,1.148285068802629,1.0254991021442907
Salamanca,2008,40-64,19165,24236,43401,5724,49125,18630,23836,42466,4869,47335,1.0287171229200214,1.0167813391508642,1.0220176140912731,1.1756007393715342,1.0378155698743001
Salamanca,2009,40-64,19268,24286,43554,5959,49513,18630,23836,42466,4869,47335,1.0342458400429415,1.0188790065447222,1.0256204963971176,1.2238652700759909,1.0460124643498467
Salamanca,2010,40-64,19484,24423,43907,6103,50010,18630,23836,42466,4869,47335,1.0458400429414922,1.0246266152038932,1.033933028775962,1.2534401314438284,1.0565120946445548
Salamanca,2011,40-64,19695,24371,44066,6106,50172,18630,23836,42466,4869,47335,1.0571658615136876,1.022445041114281,1.0376772005839967,1.2540562743889916,1.0599345093482624
Salamanca,2012,40-64,19799,24463,44262,5548,49810,18630,23836,42466,4869,47335,1.0627482555018788,1.0263047491189796,1.0422926576555362,1.1394536865886218,1.052286891306644
Salamanca,2013,40-64,19857,24494,44351,5370,49721,18630,23836,42466,4869,47335,1.0658615136876006,1.0276053029031718,1.044388451938021,1.1028958718422675,1.050406675821274
Salamanca,2014,40-64,19627,24244,43871,4953,48824,18630,23836,42466,4869,47335,1.053515834675255,1.0171169659338815,1.033085291762822,1.0172520024645717,1.0314566388507447
Salamanca,2015,40-64,19667,24272,43939,4620,48559,18630,23836,42466,4869,47335,1.0556629092860976,1.018291659674442,1.034686572787642,0.9488601355514479,1.025858244428013
Salamanca,2016,40-64,19804,24268,44072,4666,48738,18630,23836,42466,4869,47335,1.0630166398282341,1.0181238462829334,1.0378184900861867,0.9583076607106182,1.029639801415443
Salamanca,2017,40-64,19872,24232,44104,4858,48962,18630,23836,42466,4869,47335,1.0666666666666667,1.0166135257593556,1.0385720340978666,0.997740809201068,1.0343720291539031
Salamanca,2004,65-84,10157,17760,27917,677,28594,10157,17760,27917,677,28594,1.0,1.0,1.0,1.0,1.0
Salamanca,2005,65-84,9949,17364,27313,724,28037,10157,17760,27917,677,28594,0.9795215122575563,0.9777027027027027,0.9783644374395529,1.069423929098966,0.9805203888927747
Salamanca,2006,65-84,9931,17293,27224,773,27997,10157,17760,27917,677,28594,0.977749335433691,0.9737049549549549,0.9751764158039904,1.1418020679468242,0.9791214940197244
Salamanca,2007,65-84,9875,16876,26751,577,27328,10157,17760,27917,677,28594,0.9722358964261101,0.9502252252252252,0.9582333345273489,0.8522895125553914,0.9557249772679584
Salamanca,2008,65-84,9853,16808,26661,585,27246,10157,17760,27917,677,28594,0.9700699025302747,0.9463963963963964,0.955009492423971,0.8641063515509602,0.9528572427782053
Salamanca,2009,65-84,9828,16785,26613,613,27226,10157,17760,27917,677,28594,0.9676085458304617,0.9451013513513513,0.9532901099688362,0.9054652880354506,0.9521577953416801
Salamanca,2010,65-84,9865,16722,26587,664,27251,10157,17760,27917,677,28594,0.9712513537461849,0.941554054054054,0.9523587778056382,0.9807976366322009,0.9530321046373365
Salamanca,2011,65-84,9955,16574,26529,686,27215,10157,17760,27917,677,28594,0.9801122378655115,0.9332207207207207,0.9502811906723502,1.0132939438700148,0.9517730992515913
Salamanca,2012,65-84,9913,16510,26423,624,27047,10157,17760,27917,677,28594,0.9759771586098257,0.9296171171171171,0.9464842210839274,0.9217134416543574,0.9458977407847801
Salamanca,2013,65-84,9971,16448,26419,653,27072,10157,17760,27917,677,28594,0.9816875061533917,0.9261261261261261,0.9463409392126662,0.9645494830132939,0.9467720500804364
Salamanca,2014,65-84,10065,16461,26526,694,27220,10157,17760,27917,677,28594,0.9909422073446884,0.9268581081081081,0.9501737292689042,1.0251107828655834,0.9519479611107226
Salamanca,2015,65-84,10086,16382,26468,694,27162,10157,17760,27917,677,28594,0.9930097469725313,0.9224099099099099,0.9480961421356163,1.0251107828655834,0.9499195635447996
Salamanca,2016,65-84,10104,16296,26400,755,27155,10157,17760,27917,677,28594,0.9947819237963966,0.9175675675675675,0.9456603503241753,1.1152141802067947,0.9496747569420159
Salamanca,2017,65-84,10149,16232,26381,798,27179,10157,17760,27917,677,28594,0.9992123658560599,0.913963963963964,0.9449797614356843,1.1787296898079764,0.950514093865846
Salamanca,2004,85-100,1374,4391,5765,121,5886,1374,4391,5765,121,5886,1.0,1.0,1.0,1.0,1.0
Salamanca,2005,85-100,1364,4359,5723,119,5842,1374,4391,5765,121,5886,0.992721979621543,0.9927123662035983,0.992714657415438,0.9834710743801653,0.9925246347264696
Salamanca,2006,85-100,1389,4406,5795,122,5917,1374,4391,5765,121,5886,1.0109170305676856,1.0034160783420634,1.00520381613183,1.0082644628099173,1.0052667346245328
Salamanca,2007,85-100,1564,4717,6281,89,6370,1374,4391,5765,121,5886,1.1382823871906842,1.0742427693008427,1.089505637467476,0.7355371900826446,1.0822290180088345
Salamanca,2008,85-100,1540,4626,6166,90,6256,1374,4391,5765,121,5886,1.1208151382823872,1.0535185606923252,1.0695576756287946,0.743801652892562,1.0628610261637785
Salamanca,2009,85-100,1578,4660,6238,86,6324,1374,4391,5765,121,5886,1.148471615720524,1.0612616716010022,1.0820468343451866,0.7107438016528925,1.0744138634046891
Salamanca,2010,85-100,1644,4711,6355,101,6456,1374,4391,5765,121,5886,1.1965065502183405,1.0728763379640174,1.1023417172593235,0.8347107438016529,1.0968399592252804
Salamanca,2011,85-100,1693,4869,6562,99,6661,1374,4391,5765,121,5886,1.23216885007278,1.1088590298337508,1.1382480485689506,0.8181818181818182,1.1316683656133197
Salamanca,2012,85-100,1754,4975,6729,97,6826,1374,4391,5765,121,5886,1.2765647743813682,1.1329993167843315,1.167215958369471,0.8016528925619835,1.1597009853890587
Salamanca,2013,85-100,1846,5050,6896,92,6988,1374,4391,5765,121,5886,1.3435225618631732,1.1500797084946481,1.1961838681699912,0.7603305785123967,1.1872239211688753
Salamanca,2014,85-100,1960,5121,7081,85,7166,1374,4391,5765,121,5886,1.4264919941775838,1.1662491459804145,1.2282740676496098,0.7024793388429752,1.217465171593612
Salamanca,2015,85-100,2009,5239,7248,83,7331,1374,4391,5765,121,5886,1.4621542940320233,1.1931222956046459,1.25724197745013,0.6859504132231405,1.245497791369351
Salamanca,2016,85-100,2062,5332,7394,92,7486,1374,4391,5765,121,5886,1.5007278020378456,1.2143019813254383,1.2825672159583694,0.7603305785123967,1.271831464492015
Salamanca,2017,85-100,2104,5373,7477,82,7559,1374,4391,5765,121,5886,1.5312954876273654,1.2236392621270782,1.2969644405897658,0.6776859504132231,1.2842337750594632
Salamanca,2004,Total,58199,74327,132526,19952,152478,58199,74327,132526,19952,152478,1.0,1.0,1.0,1.0,1.0
Salamanca,2005,Total,57958,73681,131639,21296,152935,58199,74327,132526,19952,152478,0.9958590353786148,0.9913086765240088,0.9933069737259104,1.0673616680032076,1.0029971536877451
Salamanca,2006,Total,57384,72944,130328,23022,153350,58199,74327,132526,19952,152478,0.9859963229608756,0.9813930334871581,0.9834145752531579,1.153869286287089,1.005718857802437
Salamanca,2007,Total,55969,71270,127239,19407,146646,58199,74327,132526,19952,152478,0.9616831904328254,0.9588709351917877,0.960105941475635,0.9726844426623897,0.9617518592846181
Salamanca,2008,Total,56270,71740,128010,20287,148297,58199,74327,132526,19952,152478,0.9668551006031032,0.9651943439127101,0.965923667808581,1.016790296712109,0.9725796508348745
Salamanca,2009,Total,56100,71648,127748,20903,148651,58199,74327,132526,19952,152478,0.9639340882145742,0.9639565702907422,0.96394669725186,1.0476643945469126,0.9749012972363226
Salamanca,2010,Total,56036,71555,127591,20848,148439,58199,74327,132526,19952,152478,0.962834412962422,0.9627053426076662,0.962762024055657,1.0449077786688052,0.9735109327247209
Salamanca,2011,Total,56286,71628,127914,20518,148432,58199,74327,132526,19952,152478,0.9671300194161412,0.9636874890685754,0.9651992816503931,1.0283680834001603,0.9734650244625455
Salamanca,2012,Total,56289,71518,127807,18853,146660,58199,74327,132526,19952,152478,0.9671815666935858,0.9622075423466573,0.9643918929115796,0.9449178027265437,0.9618436758089691
Salamanca,2013,Total,56371,71493,127864,18432,146296,58199,74327,132526,19952,152478,0.9685905256104057,0.9618711908189487,0.9648219971930037,0.9238171611868484,0.9594564461758418
Salamanca,2014,Total,55989,70923,126912,17183,144095,58199,74327,132526,19952,152478,0.9620268389491229,0.9542023759871917,0.9576385011243077,0.8612169206094628,0.9450215768832225
Salamanca,2015,Total,55910,70866,126776,16067,142843,58199,74327,132526,19952,152478,0.9606694273097476,0.953435494504016,0.9566122874002083,0.8052826784282278,0.9368105562769711
Salamanca,2016,Total,56152,70911,127063,16656,143719,58199,74327,132526,19952,152478,0.9648275743569477,0.9540409272538916,0.9587779001856239,0.834803528468324,0.9425556473720799
Salamanca,2017,Total,56200,70898,127098,17151,144249,58199,74327,132526,19952,152478,0.9656523307960618,0.9538660244594831,0.9590419993057966,0.8596130713712911,0.9460315586510841
San Blas - Canillejas,2004,0-24,9677,9142,18819,3037,21856,9677,9142,18819,3037,21856,1.0,1.0,1.0,1.0,1.0
San Blas - Canillejas,2005,0-24,9477,8894,18371,3520,21891,9677,9142,18819,3037,21856,0.9793324377389687,0.9728724567928243,0.9761942717466391,1.1590385248600592,1.001601390922401
San Blas - Canillejas,2006,0-24,9304,8719,18023,3979,22002,9677,9142,18819,3037,21856,0.9614549963831766,0.9537300371909867,0.9577023221212604,1.3101745143233454,1.0066800878477307
San Blas - Canillejas,2007,0-24,9007,8580,17587,3953,21540,9677,9142,18819,3037,21856,0.9307636664255451,0.9385254867643842,0.9345342473032573,1.3016134343101746,0.9855417276720352
San Blas - Canillejas,2008,0-24,9079,8605,17684,4634,22318,9677,9142,18819,3037,21856,0.9382039888395164,0.9412601181360752,0.9396886125724002,1.525847876193612,1.0211383601756954
San Blas - Canillejas,2009,0-24,9111,8692,17803,4831,22634,9677,9142,18819,3037,21856,0.9415107988012814,0.9507766353095602,0.9460120091396993,1.5907145209087916,1.0355966325036603
San Blas - Canillejas,2010,0-24,9288,8847,18135,4653,22788,9677,9142,18819,3037,21856,0.9598015914022942,0.9677313498140451,0.9636537541846006,1.5321040500493908,1.0426427525622255
San Blas - Canillejas,2011,0-24,9437,9019,18456,4165,22621,9677,9142,18819,3037,21856,0.9751989252867624,0.9865456136512798,0.9807109835804241,1.3714191636483373,1.0350018301610542
San Blas - Canillejas,2012,0-24,9695,9312,19007,3436,22443,9677,9142,18819,3037,21856,1.0018600806034927,1.0185954933274994,1.0099899038206068,1.1313796509713534,1.0268576134699854
San Blas - Canillejas,2013,0-24,10056,9626,19682,3070,22752,9677,9142,18819,3037,21856,1.0391650304846543,1.0529424633559397,1.0458579095594878,1.0108659861705631,1.0409956076134699
San Blas - Canillejas,2014,0-24,10365,9896,20261,2572,22833,9677,9142,18819,3037,21856,1.0710964141779478,1.0824764821702035,1.0766246878155057,0.8468883766875206,1.0447016837481697
San Blas - Canillejas,2015,0-24,10672,10104,20776,2273,23049,9677,9142,18819,3037,21856,1.1028211222486308,1.1052286151826733,1.1039906477496149,0.7484359565360553,1.0545845534407028
San Blas - Canillejas,2016,0-24,10978,10470,21448,2227,23675,9677,9142,18819,3037,21856,1.1344424925080088,1.145263618464231,1.1396992401296562,0.7332894303589068,1.0832265739385065
San Blas - Canillejas,2017,0-24,11301,10777,22078,2304,24382,9677,9142,18819,3037,21856,1.1678206055595743,1.1788448917085976,1.173176045485945,0.7586433980902206,1.1155746705710103
San Blas - Canillejas,2004,25-39,17646,17439,35085,6599,41684,17646,17439,35085,6599,41684,1.0,1.0,1.0,1.0,1.0
San Blas - Canillejas,2005,25-39,17016,16762,33778,7793,41571,17646,17439,35085,6599,41684,0.9642978578714723,0.9611789666838695,0.9627476129400029,1.1809365055311412,0.9972891277228673
San Blas - Canillejas,2006,25-39,16370,16197,32567,9270,41837,17646,17439,35085,6599,41684,0.9276889946730137,0.9287803199724755,0.92823143793644,1.404758296711623,1.0036704730831973
San Blas - Canillejas,2007,25-39,15227,15090,30317,9657,39974,17646,17439,35085,6599,41684,0.8629151082398278,0.8653019095131601,0.8641014678637594,1.4634035459918169,0.958977065540735
San Blas - Canillejas,2008,25-39,15033,15090,30123,10149,40272,17646,17439,35085,6599,41684,0.851921115266916,0.8653019095131601,0.8585720393330483,1.5379602970146993,0.9661260915459169
San Blas - Canillejas,2009,25-39,14313,14532,28845,10659,39504,17646,17439,35085,6599,41684,0.8111186671200272,0.8333046619645622,0.8221462163317658,1.6152447340506138,0.947701756069475
San Blas - Canillejas,2010,25-39,13668,13989,27657,10484,38141,17646,17439,35085,6599,41684,0.7745664739884393,0.8021675554790986,0.7882855921333903,1.5887255644794667,0.9150033586028212
San Blas - Canillejas,2011,25-39,12976,13376,26352,10038,36390,17646,17439,35085,6599,41684,0.7353507877139295,0.7670164573656746,0.7510902094912356,1.5211395666010001,0.87299683331734
San Blas - Canillejas,2012,25-39,12533,12918,25451,8963,34414,17646,17439,35085,6599,41684,0.7102459480902188,0.7407534835713057,0.7254097192532422,1.3582360963782392,0.825592553497745
San Blas - Canillejas,2013,25-39,12084,12389,24473,8167,32640,17646,17439,35085,6599,41684,0.684801088065284,0.7104191754114342,0.697534558928317,1.2376117593574785,0.7830342577487766
San Blas - Canillejas,2014,25-39,11627,11932,23559,7040,30599,17646,17439,35085,6599,41684,0.6589028675053836,0.6842135443546075,0.6714835399743481,1.0668283073192908,0.7340706266193263
San Blas - Canillejas,2015,25-39,11345,11661,23006,6342,29348,17646,17439,35085,6599,41684,0.6429219086478523,0.6686736624806469,0.6557218184409291,0.9610547052583724,0.7040591114096536
San Blas - Canillejas,2016,25-39,11154,11426,22580,6213,28793,17646,17439,35085,6599,41684,0.6320979258755526,0.6551981191582086,0.6435798774405016,0.9415062888316411,0.6907446502255062
San Blas - Canillejas,2017,25-39,10958,11059,22017,6213,28230,17646,17439,35085,6599,41684,0.6209905927688995,0.6341533344801881,0.6275331338178709,0.9415062888316411,0.6772382688801458
San Blas - Canillejas,2004,40-64,19005,19867,38872,2913,41785,19005,19867,38872,2913,41785,1.0,1.0,1.0,1.0,1.0
San Blas - Canillejas,2005,40-64,19641,20599,40240,3544,43784,19005,19867,38872,2913,41785,1.0334648776637727,1.0368450193788694,1.0351924264251904,1.2166151733607964,1.047840134019385
San Blas - Canillejas,2006,40-64,20237,21055,41292,4315,45607,19005,19867,38872,2913,41785,1.0648250460405158,1.0597976544017718,1.0622556081498251,1.481290765533814,1.0914682302261578
San Blas - Canillejas,2007,40-64,21071,22092,43163,4726,47889,19005,19867,38872,2913,41785,1.1087082346750856,1.1119947651885036,1.1103879399053302,1.622382423618263,1.1460811295919588
San Blas - Canillejas,2008,40-64,21581,22635,44216,5001,49217,19005,19867,38872,2913,41785,1.1355432780847146,1.1393265213670911,1.1374768470878782,1.7167868177136971,1.1778628694507598
San Blas - Canillejas,2009,40-64,22347,23365,45712,5493,51205,19005,19867,38872,2913,41785,1.1758484609313338,1.1760708712941057,1.175962132125952,1.885684860968074,1.2254397511068564
San Blas - Canillejas,2010,40-64,23087,24043,47130,5900,53030,19005,19867,38872,2913,41785,1.2147855827413838,1.2101978154728947,1.2124408314467998,2.0254033642293168,1.2691157113796816
San Blas - Canillejas,2011,40-64,23709,24802,48511,5939,54450,19005,19867,38872,2913,41785,1.247513812154696,1.2484018724518045,1.247967688824861,2.0387916237555785,1.3030991982768936
San Blas - Canillejas,2012,40-64,24330,25542,49872,5468,55340,19005,19867,38872,2913,41785,1.2801894238358327,1.2856495696380934,1.2829800370446593,1.8771026433230347,1.3243987076702166
San Blas - Canillejas,2013,40-64,24985,26310,51295,5295,56590,19005,19867,38872,2913,41785,1.3146540384109444,1.3243066391503497,1.319587363655073,1.8177136972193615,1.3543137489529735
San Blas - Canillejas,2014,40-64,25206,26730,51936,4918,56854,19005,19867,38872,2913,41785,1.3262825572217838,1.3454472240398652,1.3360773821774028,1.6882938551321662,1.3606318056718918
San Blas - Canillejas,2015,40-64,25622,27426,53048,4657,57705,19005,19867,38872,2913,41785,1.348171533806893,1.3804801932853477,1.3646840913768266,1.598695502917954,1.3809979657771927
San Blas - Canillejas,2016,40-64,25961,27966,53927,4884,58811,19005,19867,38872,2913,41785,1.36600894501447,1.4076609452861528,1.3872967688824862,1.6766220391349125,1.407466794304176
San Blas - Canillejas,2017,40-64,26317,28479,54796,5164,59960,19005,19867,38872,2913,41785,1.3847408576690345,1.433482659686918,1.4096521918090141,1.7727428767593547,1.4349647002512864
San Blas - Canillejas,2004,65-84,10448,15025,25473,201,25674,10448,15025,25473,201,25674,1.0,1.0,1.0,1.0,1.0
San Blas - Canillejas,2005,65-84,10201,14798,24999,251,25250,10448,15025,25473,201,25674,0.9763591117917305,0.984891846921797,0.9813920621834884,1.2487562189054726,0.9834852379839526
San Blas - Canillejas,2006,65-84,10053,14816,24869,304,25173,10448,15025,25473,201,25674,0.9621937212863706,0.9860898502495841,0.9762886193224198,1.5124378109452736,0.9804860948819818
San Blas - Canillejas,2007,65-84,9877,14445,24322,259,24581,10448,15025,25473,201,25674,0.9453483920367535,0.9613976705490849,0.9548149020531543,1.2885572139303483,0.9574277479161798
San Blas - Canillejas,2008,65-84,9691,14249,23940,254,24194,10448,15025,25473,201,25674,0.9275459418070444,0.9483527454242928,0.9398186314921682,1.263681592039801,0.942354132585495
San Blas - Canillejas,2009,65-84,9539,14102,23641,274,23915,10448,15025,25473,201,25674,0.9129977029096478,0.9385690515806988,0.9280807129117105,1.36318407960199,0.9314871075796526
San Blas - Canillejas,2010,65-84,9486,14006,23492,301,23793,10448,15025,25473,201,25674,0.9079249617151608,0.9321797004991681,0.9222313822478703,1.4975124378109452,0.9267352185089974
San Blas - Canillejas,2011,65-84,9420,13869,23289,324,23613,10448,15025,25473,201,25674,0.9016079632465543,0.9230615640599001,0.9142621599340478,1.6119402985074627,0.9197242346342603
San Blas - Canillejas,2012,65-84,9281,13677,22958,311,23269,10448,15025,25473,201,25674,0.8883039816232772,0.9102828618968386,0.9012680092647116,1.5472636815920398,0.9063254654514294
San Blas - Canillejas,2013,65-84,9185,13493,22678,345,23023,10448,15025,25473,201,25674,0.8791156202143952,0.898036605657238,0.8902759784870254,1.7164179104477613,0.8967437874892887
San Blas - Canillejas,2014,65-84,9191,13284,22475,343,22818,10448,15025,25473,201,25674,0.8796898928024502,0.8841264559068219,0.882306756173203,1.7064676616915422,0.8887590558541716
San Blas - Canillejas,2015,65-84,9088,12997,22085,355,22440,10448,15025,25473,201,25674,0.8698315467075038,0.8650249584026622,0.8669964275899973,1.7661691542288558,0.8740359897172236
San Blas - Canillejas,2016,65-84,8958,12866,21824,435,22259,10448,15025,25473,201,25674,0.8573889739663093,0.8563061564059901,0.8567502846150826,2.1641791044776117,0.8669860559320713
San Blas - Canillejas,2017,65-84,8886,12724,21610,513,22123,10448,15025,25473,201,25674,0.8504977029096478,0.846855241264559,0.8483492325207082,2.5522388059701493,0.8616888681156033
San Blas - Canillejas,2004,85-100,634,1602,2236,15,2251,634,1602,2236,15,2251,1.0,1.0,1.0,1.0,1.0
San Blas - Canillejas,2005,85-100,653,1645,2298,17,2315,634,1602,2236,15,2251,1.0299684542586751,1.0268414481897628,1.0277280858676208,1.1333333333333333,1.0284318080852954
San Blas - Canillejas,2006,85-100,689,1717,2406,15,2421,634,1602,2236,15,2251,1.086750788643533,1.071785268414482,1.0760286225402504,1.0,1.075521990226566
San Blas - Canillejas,2007,85-100,819,1976,2795,15,2810,634,1602,2236,15,2251,1.2917981072555205,1.233458177278402,1.25,1.0,1.2483340737450022
San Blas - Canillejas,2008,85-100,822,1981,2803,11,2814,634,1602,2236,15,2251,1.2965299684542586,1.2365792759051186,1.253577817531306,0.7333333333333333,1.2501110617503333
San Blas - Canillejas,2009,85-100,892,2157,3049,9,3058,634,1602,2236,15,2251,1.4069400630914826,1.3464419475655431,1.3635957066189623,0.6,1.358507330075522
San Blas - Canillejas,2010,85-100,996,2371,3367,8,3375,634,1602,2236,15,2251,1.5709779179810726,1.4800249687890137,1.505813953488372,0.5333333333333333,1.4993336294980009
San Blas - Canillejas,2011,85-100,1047,2571,3618,8,3626,634,1602,2236,15,2251,1.6514195583596214,1.604868913857678,1.618067978533095,0.5333333333333333,1.610839626832519
San Blas - Canillejas,2012,85-100,1163,2704,3867,9,3876,634,1602,2236,15,2251,1.834384858044164,1.6878901373283395,1.729427549194991,0.6,1.7219013771657041
San Blas - Canillejas,2013,85-100,1262,2946,4208,11,4219,634,1602,2236,15,2251,1.9905362776025237,1.8389513108614233,1.881932021466905,0.7333333333333333,1.8742780986228342
San Blas - Canillejas,2014,85-100,1388,3223,4611,13,4624,634,1602,2236,15,2251,2.189274447949527,2.011860174781523,2.0621645796064403,0.8666666666666667,2.0541981341625943
San Blas - Canillejas,2015,85-100,1477,3420,4897,11,4908,634,1602,2236,15,2251,2.329652996845426,2.134831460674157,2.190071556350626,0.7333333333333333,2.1803642825410927
San Blas - Canillejas,2016,85-100,1661,3641,5302,17,5319,634,1602,2236,15,2251,2.6198738170347005,2.272784019975031,2.3711985688729875,1.1333333333333333,2.3629498000888494
San Blas - Canillejas,2017,85-100,1755,3803,5558,21,5579,634,1602,2236,15,2251,2.7681388012618298,2.373907615480649,2.4856887298747763,1.4,2.478454020435362
San Blas - Canillejas,2004,Total,64145,69365,133510,14159,147669,64145,69365,133510,14159,147669,1.0,1.0,1.0,1.0,1.0
San Blas - Canillejas,2005,Total,64056,69284,133340,16569,149909,64145,69365,133510,14159,147669,0.9986125185127446,0.998832264110142,0.9987266871395402,1.170209760576312,1.0151690605340322
San Blas - Canillejas,2006,Total,64013,69465,133478,19485,152963,64145,69365,133510,14159,147669,0.9979421622885649,1.0014416492467382,0.9997603175792076,1.3761565082279823,1.0358504493156993
San Blas - Canillejas,2007,Total,63534,69284,132818,20210,153028,64145,69365,133510,14159,147669,0.9904747057447969,0.998832264110142,0.9948168676503633,1.427360689314217,1.0362906229472673
San Blas - Canillejas,2008,Total,64102,70086,134188,21851,156039,64145,69365,133510,14159,147669,0.9993296437758205,1.010394291068983,1.00507827129054,1.5432587047107846,1.056680819941897
San Blas - Canillejas,2009,Total,64405,70530,134935,23073,158008,64145,69365,133510,14159,147669,1.0040533167043417,1.0167952137245009,1.0106733578009137,1.629564234762342,1.0700146950273923
San Blas - Canillejas,2010,Total,64752,70989,135741,23170,158911,64145,69365,133510,14159,147669,1.0094629355366747,1.0234123837670295,1.0167103587746236,1.6364150010593967,1.076129722555174
San Blas - Canillejas,2011,Total,64716,71364,136080,22248,158328,64145,69365,133510,14159,147669,1.0089017070699198,1.028818568442298,1.0192494944198935,1.5712974080090403,1.0721817036751111
San Blas - Canillejas,2012,Total,64963,71679,136642,19849,156491,64145,69365,133510,14159,147669,1.0127523579390443,1.0333597635695235,1.023458916935061,1.4018645384561057,1.0597417196568
San Blas - Canillejas,2013,Total,65363,72182,137545,18507,156052,64145,69365,133510,14159,147669,1.0189882297918778,1.040611259280617,1.030222455246798,1.307083833604068,1.0567688546682106
San Blas - Canillejas,2014,Total,65177,72190,137367,16421,153788,64145,69365,133510,14159,147669,1.0160885493803102,1.040726591220356,1.02888922178114,1.1597570449890529,1.0414372684855995
San Blas - Canillejas,2015,Total,65265,72432,137697,15083,152780,64145,69365,133510,14159,147669,1.0174604411879336,1.0442153823974627,1.0313609467455622,1.065258845963698,1.0346111912452851
San Blas - Canillejas,2016,Total,65633,72961,138594,15262,153856,64145,69365,133510,14159,147669,1.0231974432925404,1.0518417069127082,1.0380795446034006,1.0779009817077476,1.0418977578232398
San Blas - Canillejas,2017,Total,65836,73202,139038,15744,154782,64145,69365,133510,14159,147669,1.0263621482578533,1.0553160815973475,1.0414051381918958,1.11194293382301,1.0481685390975763
Tetuán,2004,0-24,7711,7669,15380,6437,21817,7711,7669,15380,6437,21817,1.0,1.0,1.0,1.0,1.0
Tetuán,2005,0-24,7423,7331,14754,6280,21034,7711,7669,15380,6437,21817,0.9626507586564648,0.9559264571652106,0.959297789336801,0.975609756097561,0.9641105559884494
Tetuán,2006,0-24,7263,7088,14351,6410,20761,7711,7669,15380,6437,21817,0.9419011801322785,0.9242404485591342,0.9330949284785436,0.9958054994562684,0.9515973781913187
Tetuán,2007,0-24,6999,6734,13733,5675,19408,7711,7669,15380,6437,21817,0.9076643755673713,0.8780805841700352,0.8929128738621587,0.8816218735435762,0.8895815189989458
Tetuán,2008,0-24,7009,6862,13871,6269,20140,7711,7669,15380,6437,21817,0.9089612242251329,0.8947711566045117,0.9018855656697009,0.9739008855056703,0.9231333363890544
Tetuán,2009,0-24,7049,6838,13887,6452,20339,7711,7669,15380,6437,21817,0.9141486188561795,0.8916416742730473,0.902925877763329,1.0023302780798509,0.9322546637942889
Tetuán,2010,0-24,6965,6811,13776,6079,19855,7711,7669,15380,6437,21817,0.9032550901309817,0.8881210066501499,0.8957087126137842,0.9443840298275594,0.9100701287986432
Tetuán,2011,0-24,7010,6713,13723,5493,19216,7711,7669,15380,6437,21817,0.9090909090909091,0.875342287130004,0.8922626788036411,0.8533478328413857,0.8807810423064583
Tetuán,2012,0-24,7119,6797,13916,5005,18921,7711,7669,15380,6437,21817,0.9232265594605109,0.8862954752901291,0.9048114434330299,0.7775361193102377,0.86725947655498
Tetuán,2013,0-24,7097,6881,13978,4664,18642,7711,7669,15380,6437,21817,0.9203734924134354,0.8972486634502542,0.9088426527958388,0.7245611309616281,0.8544712838612092
Tetuán,2014,0-24,7114,6843,13957,4230,18187,7711,7669,15380,6437,21817,0.9225781351316301,0.8922936497587691,0.9074772431729519,0.6571384185179432,0.833615987532658
Tetuán,2015,0-24,7229,6925,14154,3723,17877,7711,7669,15380,6437,21817,0.937491894695889,0.9029860477246056,0.9202860858257478,0.578375019418984,0.8194068845395792
Tetuán,2016,0-24,7340,7019,14359,3871,18230,7711,7669,15380,6437,21817,0.9518869147970432,0.9152431868561742,0.9336150845253576,0.6013670964735125,0.8355869276252463
Tetuán,2017,0-24,7471,7160,14631,3920,18551,7711,7669,15380,6437,21817,0.9688756322137206,0.9336288955535272,0.9513003901170352,0.6089793382010253,0.8503002245954989
Tetuán,2004,25-39,14215,14535,28750,13575,42325,14215,14535,28750,13575,42325,1.0,1.0,1.0,1.0,1.0
Tetuán,2005,25-39,14100,14304,28404,14440,42844,14215,14535,28750,13575,42325,0.9919099542736546,0.9841073271413828,0.9879652173913044,1.0637200736648251,1.012262256349675
Tetuán,2006,25-39,13784,13912,27696,15920,43616,14215,14535,28750,13575,42325,0.9696799155821315,0.9571379428964568,0.9633391304347826,1.172744014732965,1.0305020673360898
Tetuán,2007,25-39,13707,13897,27604,14755,42359,14215,14535,28750,13575,42325,0.9642631023566655,0.9561059511523908,0.9601391304347826,1.0869244935543279,1.0008033077377436
Tetuán,2008,25-39,13752,14084,27836,15752,43588,14215,14535,28750,13575,42325,0.9674287724234963,0.9689714482284142,0.9682086956521739,1.1603683241252303,1.0298405197873597
Tetuán,2009,25-39,13769,14083,27852,16486,44338,14215,14535,28750,13575,42325,0.9686246922265213,0.9689026487788097,0.9687652173913044,1.214438305709024,1.0475605434140578
Tetuán,2010,25-39,13816,14057,27873,16581,44454,14215,14535,28750,13575,42325,0.9719310587407668,0.9671138630890953,0.9694956521739131,1.221436464088398,1.0503012404016538
Tetuán,2011,25-39,13614,13925,27539,16347,43886,14215,14535,28750,13575,42325,0.9577207175518818,0.9580323357413141,0.9578782608695652,1.2041988950276243,1.0368812758417012
Tetuán,2012,25-39,13758,13922,27680,15203,42883,14215,14535,28750,13575,42325,0.9678508617657404,0.9578259373925009,0.9627826086956521,1.119926335174954,1.0131836975782635
Tetuán,2013,25-39,13895,14027,27922,14434,42356,14215,14535,28750,13575,42325,0.9774885684136475,0.9650498796009632,0.9712,1.0632780847145489,1.0007324276432368
Tetuán,2014,25-39,13732,13789,27521,12764,40285,14215,14535,28750,13575,42325,0.9660218079493493,0.9486756105951153,0.9572521739130435,0.9402578268876611,0.951801535735381
Tetuán,2015,25-39,13545,13702,27247,11433,38680,14215,14535,28750,13575,42325,0.9528666901160746,0.9426900584795321,0.9477217391304348,0.8422099447513812,0.9138806851742469
Tetuán,2016,25-39,13677,13686,27363,11528,38891,14215,14535,28750,13575,42325,0.9621526556454449,0.9415892672858617,0.9517565217391304,0.849208103130755,0.9188659184878913
Tetuán,2017,25-39,13694,13780,27474,11648,39122,14215,14535,28750,13575,42325,0.96334857544847,0.9480564155486756,0.9556173913043479,0.8580478821362799,0.9243236857649143
Tetuán,2004,40-64,16965,21295,38260,6248,44508,16965,21295,38260,6248,44508,1.0,1.0,1.0,1.0,1.0
Tetuán,2005,40-64,17385,21679,39064,7130,46194,16965,21295,38260,6248,44508,1.0247568523430592,1.018032401972294,1.0210141139571354,1.1411651728553136,1.03788083041251
Tetuán,2006,40-64,17431,21843,39274,8200,47474,16965,21295,38260,6248,44508,1.0274683171234895,1.0257337403146278,1.0265028750653424,1.3124199743918055,1.0666397052215333
Tetuán,2007,40-64,17908,22176,40084,7699,47783,16965,21295,38260,6248,44508,1.055585027998821,1.0413712138999764,1.0476738107684265,1.232234314980794,1.073582277343399
Tetuán,2008,40-64,18072,22410,40482,7976,48458,16965,21295,38260,6248,44508,1.0652519893899204,1.052359708851843,1.0580763199163616,1.2765685019206146,1.0887480902309696
Tetuán,2009,40-64,18445,22567,41012,8565,49577,16965,21295,38260,6248,44508,1.0872384320660182,1.0597323315332237,1.07192890747517,1.3708386683738796,1.1138896378179204
Tetuán,2010,40-64,18680,22746,41426,8983,50409,16965,21295,38260,6248,44508,1.1010904804008252,1.0681380605776003,1.0827496079456351,1.4377400768245838,1.1325829064437853
Tetuán,2011,40-64,18985,22870,41855,9130,50985,16965,21295,38260,6248,44508,1.1190686707928088,1.073961023714487,1.0939623627809723,1.4612676056338028,1.1455244001078457
Tetuán,2012,40-64,19329,23306,42635,8754,51389,16965,21295,38260,6248,44508,1.139345711759505,1.0944353134538625,1.1143491897543125,1.401088348271447,1.1546014199694437
Tetuán,2013,40-64,19762,23775,43537,8533,52070,16965,21295,38260,6248,44508,1.1648688476274682,1.1164592627377319,1.1379247255619447,1.3657170294494239,1.1699020400826818
Tetuán,2014,40-64,19915,23831,43746,8030,51776,16965,21295,38260,6248,44508,1.1738874152667256,1.119088988025358,1.1433873497124936,1.2852112676056338,1.1632964860249844
Tetuán,2015,40-64,20272,24193,44465,7580,52045,16965,21295,38260,6248,44508,1.194930739758326,1.136088283634656,1.1621798222686879,1.2131882202304738,1.169340343309068
Tetuán,2016,40-64,20598,24527,45125,8026,53151,16965,21295,38260,6248,44508,1.2141467727674624,1.1517727166001408,1.1794302143230528,1.2845710627400768,1.1941898085737395
Tetuán,2017,40-64,20764,24681,45445,8287,53732,16965,21295,38260,6248,44508,1.223931623931624,1.159004461141113,1.187794040773654,1.3263444302176697,1.2072436415925227
Tetuán,2004,65-84,10467,16865,27332,591,27923,10467,16865,27332,591,27923,1.0,1.0,1.0,1.0,1.0
Tetuán,2005,65-84,10187,16469,26656,654,27310,10467,16865,27332,591,27923,0.9732492595777205,0.9765194189149126,0.9752670861993268,1.1065989847715736,0.9780467714787093
Tetuán,2006,65-84,10086,16321,26407,766,27173,10467,16865,27332,591,27923,0.9635998853539696,0.9677438482063445,0.9661568857017415,1.2961082910321489,0.9731404218744404
Tetuán,2007,65-84,9968,16012,25980,619,26599,10467,16865,27332,591,27923,0.9523263590331518,0.9494218796323748,0.9505341723986536,1.0473773265651438,0.9525838914156788
Tetuán,2008,65-84,9860,15768,25628,586,26214,10467,16865,27332,591,27923,0.942008216298844,0.9349540468425733,0.937655495390019,0.9915397631133672,0.9387959746445582
Tetuán,2009,65-84,9734,15570,25304,628,25932,10467,16865,27332,591,27923,0.9299703831088182,0.9232137563000297,0.9258012585979803,1.0626057529610828,0.9286967732693479
Tetuán,2010,65-84,9666,15457,25123,690,25813,10467,16865,27332,591,27923,0.9234737747205503,0.9165134894752446,0.9191789843406996,1.16751269035533,0.9244350535400924
Tetuán,2011,65-84,9548,15282,24830,710,25540,10467,16865,27332,591,27923,0.9122002483997325,0.9061369700563296,0.908458949217035,1.2013536379018612,0.9146581671023887
Tetuán,2012,65-84,9434,15017,24451,691,25142,10467,16865,27332,591,27923,0.9013088755135187,0.8904239549362585,0.8945924191423972,1.1692047377326564,0.9004046843104251
Tetuán,2013,65-84,9325,14836,24161,686,24847,10467,16865,27332,591,27923,0.8908951944205599,0.8796916691372665,0.8839821454705108,1.1607445008460238,0.8898399169143717
Tetuán,2014,65-84,9251,14633,23884,643,24527,10467,16865,27332,591,27923,0.883825355880386,0.8676549066113253,0.8738475047563296,1.0879864636209813,0.8783798302474662
Tetuán,2015,65-84,9226,14530,23756,659,24415,10467,16865,27332,591,27923,0.881436896914111,0.8615475837533353,0.8691643494804625,1.1150592216582065,0.8743687999140494
Tetuán,2016,65-84,9141,14346,23487,714,24201,10467,16865,27332,591,27923,0.8733161364287761,0.8506374147643048,0.8593224059710229,1.2081218274111676,0.8667048669555564
Tetuán,2017,65-84,9014,14181,23195,813,24008,10467,16865,27332,591,27923,0.8611827648800994,0.840853839312185,0.8486389579979511,1.3756345177664975,0.859793002184579
Tetuán,2004,85-100,1188,3036,4224,45,4269,1188,3036,4224,45,4269,1.0,1.0,1.0,1.0,1.0
Tetuán,2005,85-100,1185,3043,4228,53,4281,1188,3036,4224,45,4269,0.9974747474747475,1.0023056653491436,1.0009469696969697,1.1777777777777778,1.0028109627547435
Tetuán,2006,85-100,1242,3172,4414,55,4469,1188,3036,4224,45,4269,1.0454545454545454,1.0447957839262187,1.0449810606060606,1.2222222222222223,1.046849379245725
Tetuán,2007,85-100,1411,3457,4868,32,4900,1188,3036,4224,45,4269,1.1877104377104377,1.13866930171278,1.152462121212121,0.7111111111111111,1.1478097915202623
Tetuán,2008,85-100,1369,3411,4780,32,4812,1188,3036,4224,45,4269,1.1523569023569022,1.1235177865612649,1.1316287878787878,0.7111111111111111,1.1271960646521433
Tetuán,2009,85-100,1442,3553,4995,38,5033,1188,3036,4224,45,4269,1.2138047138047139,1.1702898550724639,1.1825284090909092,0.8444444444444444,1.1789646287186695
Tetuán,2010,85-100,1535,3719,5254,44,5298,1188,3036,4224,45,4269,1.2920875420875422,1.2249670619235837,1.243844696969697,0.9777777777777777,1.2410400562192552
Tetuán,2011,85-100,1582,3850,5432,47,5479,1188,3036,4224,45,4269,1.3316498316498318,1.2681159420289856,1.2859848484848484,1.0444444444444445,1.2834387444366362
Tetuán,2012,85-100,1642,4055,5697,46,5743,1188,3036,4224,45,4269,1.3821548821548821,1.335638998682477,1.3487215909090908,1.0222222222222221,1.3452799250409933
Tetuán,2013,85-100,1750,4158,5908,49,5957,1188,3036,4224,45,4269,1.473063973063973,1.3695652173913044,1.3986742424242424,1.0888888888888888,1.395408760833919
Tetuán,2014,85-100,1874,4332,6206,52,6258,1188,3036,4224,45,4269,1.5774410774410774,1.4268774703557312,1.4692234848484849,1.1555555555555554,1.465917076598735
Tetuán,2015,85-100,1926,4466,6392,48,6440,1188,3036,4224,45,4269,1.621212121212121,1.4710144927536233,1.5132575757575757,1.0666666666666667,1.5085500117123447
Tetuán,2016,85-100,1996,4600,6596,51,6647,1188,3036,4224,45,4269,1.6801346801346801,1.5151515151515151,1.5615530303030303,1.1333333333333333,1.5570391192316702
Tetuán,2017,85-100,2039,4651,6690,61,6751,1188,3036,4224,45,4269,1.7163299663299663,1.5319499341238472,1.5838068181818181,1.3555555555555556,1.5814007964394472
Tetuán,2004,Total,54808,67322,122130,29924,152054,54808,67322,122130,29924,152054,1.0,1.0,1.0,1.0,1.0
Tetuán,2005,Total,54645,66869,121514,31439,152953,54808,67322,122130,29924,152054,0.9970259816085243,0.9932711446481091,0.9949561942192745,1.050628258254244,1.0059123732358242
Tetuán,2006,Total,54261,66587,120848,34294,155142,54808,67322,122130,29924,152054,0.9900197051525325,0.989082320786667,0.989502988618685,1.1460366261195027,1.0203085745853446
Tetuán,2007,Total,54433,66554,120987,31180,152167,54808,67322,122130,29924,152054,0.9931579331484455,0.9885921392709665,0.9906411201179072,1.0419729982622643,1.0007431570363161
Tetuán,2008,Total,54670,66984,121654,33316,154970,54808,67322,122130,29924,152054,0.997482119398628,0.9949793529603993,0.996102513714894,1.1133538297019114,1.0191773975035185
Tetuán,2009,Total,55195,67264,122459,34944,157403,54808,67322,122130,29924,152054,1.0070610129908042,0.9991384688511927,1.0026938508147056,1.1677583210800695,1.0351782919226065
Tetuán,2010,Total,55586,67635,123221,35077,158298,54808,67322,122130,29924,152054,1.014195008028025,1.0046492974064942,1.0089331040694343,1.1722029140489238,1.041064358714667
Tetuán,2011,Total,55740,67540,123280,34390,157670,54808,67322,122130,29924,152054,1.0170048168150634,1.0032381688006893,1.009416195856874,1.1492447533752173,1.0369342470438134
Tetuán,2012,Total,56289,67965,124254,32197,156451,54808,67322,122130,29924,152054,1.0270216026857393,1.0095511125635008,1.017391304347826,1.0759590963774897,1.0289173583069173
Tetuán,2013,Total,56957,68489,125446,30887,156333,54808,67322,122130,29924,152054,1.0392096044373085,1.0173346008734143,1.0271513960533858,1.0321815265338858,1.028141318215897
Tetuán,2014,Total,56914,68230,125144,27999,153143,54808,67322,122130,29924,152054,1.03842504743833,1.0134874186744303,1.0246786211414067,0.9356703649244753,1.0071619293145857
Tetuán,2015,Total,57242,68668,125910,25403,151313,54808,67322,122130,29924,152054,1.04440957524449,1.0199934642464574,1.0309506263817243,0.8489172570511964,0.9951267312928301
Tetuán,2016,Total,57919,69057,126976,26100,153076,54808,67322,122130,29924,152054,1.0567617866004964,1.0257716645375954,1.0396790305412265,0.8722095976473734,1.0067212963815486
Tetuán,2017,Total,58177,69302,127479,26743,154222,54808,67322,122130,29924,152054,1.0614691285943658,1.0294108909420399,1.0437975927290593,0.8936973666622109,1.0142580925197626
Usera,2004,0-24,7978,7681,15659,4939,20598,7978,7681,15659,4939,20598,1.0,1.0,1.0,1.0,1.0
Usera,2005,0-24,7664,7405,15069,5597,20666,7978,7681,15659,4939,20598,0.9606417648533467,0.9640671787527666,0.9623219873555144,1.133225349260984,1.0033012913875134
Usera,2006,0-24,7389,7128,14517,6247,20764,7978,7681,15659,4939,20598,0.9261719729255452,0.9280041661242026,0.9270706941694872,1.2648309374367281,1.0080590348577532
Usera,2007,0-24,7041,6829,13870,6143,20013,7978,7681,15659,4939,20598,0.8825520180496365,0.8890769431063663,0.885752602337314,1.243774043328609,0.9715991843868337
Usera,2008,0-24,7032,6809,13841,7289,21130,7978,7681,15659,4939,20598,0.881423915768363,0.8864731154797553,0.88390063222428,1.4758048187892285,1.0258277502670161
Usera,2009,0-24,7047,6797,13844,7353,21197,7978,7681,15659,4939,20598,0.8833040862371522,0.8849108189037885,0.8840922153394214,1.488762907471148,1.029080493251772
Usera,2010,0-24,7086,6821,13907,6977,20884,7978,7681,15659,4939,20598,0.888192529456004,0.8880354120557219,0.8881154607573919,1.4126341364648713,1.0138848431886591
Usera,2011,0-24,7065,6931,13996,6248,20244,7978,7681,15659,4939,20598,0.8855602907996992,0.902356464002083,0.893799093173255,1.265033407572383,0.9828138654238275
Usera,2012,0-24,7289,7102,14391,5444,19835,7978,7681,15659,4939,20598,0.9136375031336175,0.9246191902096081,0.9190242033335462,1.1022474185057705,0.9629575686959899
Usera,2013,0-24,7512,7270,14782,4823,19605,7978,7681,15659,4939,20598,0.9415893707696165,0.9464913422731415,0.9439938693403155,0.9765134642640211,0.9517914360617535
Usera,2014,0-24,7739,7400,15139,4265,19404,7978,7681,15659,4939,20598,0.9700426171972926,0.9634162218461138,0.9667922600421482,0.8635351285685361,0.9420332071074862
Usera,2015,0-24,7957,7643,15600,3972,19572,7978,7681,15659,4939,20598,0.9973677613436952,0.9950527275094389,0.9962321987355515,0.8042113788216239,0.9501893387707544
Usera,2016,0-24,8282,7853,16135,4031,20166,7978,7681,15659,4939,20598,1.0381047881674605,1.0223929175888555,1.0303978542691103,0.8161571168252683,0.9790270900087387
Usera,2017,0-24,8468,8061,16529,4155,20684,7978,7681,15659,4939,20598,1.0614189019804463,1.0494727249056113,1.0555591033910212,0.8412634136464872,1.0041751626371493
Usera,2004,25-39,13690,13350,27040,9760,36800,13690,13350,27040,9760,36800,1.0,1.0,1.0,1.0,1.0
Usera,2005,25-39,13393,13096,26489,11715,38204,13690,13350,27040,9760,36800,0.9783053323593864,0.9809737827715356,0.9796227810650887,1.2003073770491803,1.0381521739130435
Usera,2006,25-39,13088,12797,25885,13786,39671,13690,13350,27040,9760,36800,0.9560262965668371,0.9585767790262172,0.9572855029585798,1.4125,1.0780163043478261
Usera,2007,25-39,12214,12192,24406,14082,38488,13690,13350,27040,9760,36800,0.8921840759678598,0.9132584269662921,0.9025887573964497,1.442827868852459,1.0458695652173913
Usera,2008,25-39,11937,12005,23942,15384,39326,13690,13350,27040,9760,36800,0.8719503287070854,0.899250936329588,0.8854289940828403,1.5762295081967213,1.068641304347826
Usera,2009,25-39,11573,11676,23249,15970,39219,13690,13350,27040,9760,36800,0.8453615777940102,0.8746067415730338,0.8598002958579881,1.6362704918032787,1.065733695652174
Usera,2010,25-39,11130,11278,22408,16299,38707,13690,13350,27040,9760,36800,0.8130021913805697,0.8447940074906367,0.828698224852071,1.6699795081967213,1.051820652173913
Usera,2011,25-39,10703,10851,21554,15549,37103,13690,13350,27040,9760,36800,0.7818115412710007,0.812808988764045,0.7971153846153847,1.5931352459016392,1.008233695652174
Usera,2012,25-39,10294,10527,20821,13777,34598,13690,13350,27040,9760,36800,0.7519357195032871,0.7885393258426966,0.7700073964497042,1.411577868852459,0.9401630434782609
Usera,2013,25-39,10021,10404,20425,12174,32599,13690,13350,27040,9760,36800,0.7319941563184806,0.7793258426966292,0.755362426035503,1.2473360655737704,0.8858423913043478
Usera,2014,25-39,9565,10134,19699,10577,30276,13690,13350,27040,9760,36800,0.6986851716581446,0.7591011235955056,0.7285133136094675,1.0837090163934426,0.8227173913043478
Usera,2015,25-39,9293,9970,19263,9475,28738,13690,13350,27040,9760,36800,0.6788166544923302,0.746816479400749,0.7123890532544379,0.9707991803278688,0.7809239130434783
Usera,2016,25-39,8982,9691,18673,9583,28256,13690,13350,27040,9760,36800,0.656099342585829,0.7259176029962546,0.6905695266272189,0.9818647540983606,0.7678260869565218
Usera,2017,25-39,8618,9181,17799,9837,27636,13690,13350,27040,9760,36800,0.6295105916727538,0.6877153558052435,0.6582470414201184,1.0078893442622952,0.7509782608695652
Usera,2004,40-64,14775,16223,30998,4054,35052,14775,16223,30998,4054,35052,1.0,1.0,1.0,1.0,1.0
Usera,2005,40-64,15181,16513,31694,5015,36709,14775,16223,30998,4054,35052,1.0274788494077833,1.0178758552672131,1.022453061487838,1.237049827331031,1.0472726235307543
Usera,2006,40-64,15267,16587,31854,6136,37990,14775,16223,30998,4054,35052,1.0332994923857868,1.0224372804043642,1.0276146848183754,1.5135668475579673,1.083818327056944
Usera,2007,40-64,15698,16957,32655,6441,39096,14775,16223,30998,4054,35052,1.0624703891708969,1.045244406090119,1.0534550616168785,1.588801184015787,1.1153714481342005
Usera,2008,40-64,15915,17255,33170,7054,40224,14775,16223,30998,4054,35052,1.0771573604060913,1.0636133883991863,1.070069036712046,1.740009866798224,1.1475522081478946
Usera,2009,40-64,16181,17571,33752,7795,41547,14775,16223,30998,4054,35052,1.095160744500846,1.0830919065524256,1.0888444415768759,1.9227923038973853,1.1852961314618282
Usera,2010,40-64,16537,17824,34361,8324,42685,14775,16223,30998,4054,35052,1.1192554991539763,1.0986870492510632,1.1084908703787342,2.053280710409472,1.2177621819011755
Usera,2011,40-64,16996,18200,35196,8603,43799,14775,16223,30998,4054,35052,1.150321489001692,1.1218640202182086,1.1354280921349764,2.122101628021707,1.2495435353189548
Usera,2012,40-64,17447,18726,36173,8402,44575,14775,16223,30998,4054,35052,1.1808460236886633,1.1542871232201195,1.1669462545970708,2.072520966946226,1.271682072349652
Usera,2013,40-64,17893,19254,37147,7942,45089,14775,16223,30998,4054,35052,1.2110321489001692,1.186833507982494,1.1983676366217175,1.9590527873704984,1.2863460002282323
Usera,2014,40-64,18275,19674,37949,7698,45647,14775,16223,30998,4054,35052,1.236886632825719,1.2127226776798372,1.2242402735660365,1.8988653182042428,1.3022652059796873
Usera,2015,40-64,18669,20295,38964,7479,46443,14775,16223,30998,4054,35052,1.2635532994923857,1.2510016643037662,1.2569843215691334,1.8448445979279724,1.3249743238616911
Usera,2016,40-64,19100,20846,39946,8067,48013,14775,16223,30998,4054,35052,1.2927241962774958,1.2849657893114714,1.288663784760307,1.9898865318204242,1.3697649206892617
Usera,2017,40-64,19405,21311,40716,8729,49445,14775,16223,30998,4054,35052,1.31336717428088,1.3136287986192443,1.3135040970385186,2.1531820424272325,1.4106185096428163
Usera,2004,65-84,9564,13703,23267,291,23558,9564,13703,23267,291,23558,1.0,1.0,1.0,1.0,1.0
Usera,2005,65-84,9360,13508,22868,367,23235,9564,13703,23267,291,23558,0.9786700125470514,0.9857695395168941,0.9828512485494477,1.261168384879725,0.9862891586722132
Usera,2006,65-84,9255,13580,22835,423,23258,9564,13703,23267,291,23558,0.9676913425345044,0.9910238633875793,0.9814329307603042,1.4536082474226804,0.9872654724509721
Usera,2007,65-84,9003,13182,22185,354,22539,9564,13703,23267,291,23558,0.9413425345043914,0.9619791286579581,0.9534963682468732,1.2164948453608246,0.9567450547584685
Usera,2008,65-84,8859,13005,21864,372,22236,9564,13703,23267,291,23558,0.9262860727728983,0.9490622491425236,0.9397000042979327,1.2783505154639174,0.9438831819339503
Usera,2009,65-84,8685,12826,21511,402,21913,9564,13703,23267,291,23558,0.9080928481806776,0.9359994161862366,0.9245283018867925,1.3814432989690721,0.9301723406061635
Usera,2010,65-84,8513,12695,21208,397,21605,9564,13703,23267,291,23558,0.8901087411125053,0.9264394658104065,0.9115055658228393,1.3642611683848798,0.9170982256558282
Usera,2011,65-84,8392,12553,20945,405,21350,9564,13703,23267,291,23558,0.87745713090757,0.9160767715098883,0.9002020028366355,1.3917525773195876,0.9062738772391544
Usera,2012,65-84,8177,12333,20510,401,20911,9564,13703,23267,291,23558,0.8549769970723546,0.9000218930161279,0.8815059956161087,1.3780068728522337,0.8876390185924102
Usera,2013,65-84,8041,12147,20188,425,20613,9564,13703,23267,291,23558,0.8407570054370557,0.8864482230168577,0.8676666523402243,1.4604810996563573,0.8749893878937092
Usera,2014,65-84,7976,11972,19948,431,20379,9564,13703,23267,291,23558,0.8339606859054789,0.8736772969422754,0.8573516138737267,1.4810996563573884,0.8650564564054674
Usera,2015,65-84,7828,11744,19572,428,20000,9564,13703,23267,291,23558,0.8184859891258888,0.8570386046851054,0.8411913869428804,1.470790378006873,0.8489685032685287
Usera,2016,65-84,7644,11442,19086,462,19548,9564,13703,23267,291,23558,0.7992471769134254,0.8349996351163979,0.8203034340482228,1.5876288659793814,0.82978181509466
Usera,2017,65-84,7424,11111,18535,559,19094,9564,13703,23267,291,23558,0.7762442492680887,0.810844340655331,0.796621824902222,1.9209621993127148,0.8105102300704644
Usera,2004,85-100,661,1700,2361,18,2379,661,1700,2361,18,2379,1.0,1.0,1.0,1.0,1.0
Usera,2005,85-100,671,1778,2449,17,2466,661,1700,2361,18,2379,1.0151285930408471,1.0458823529411765,1.0372723422278696,0.9444444444444444,1.0365699873896594
Usera,2006,85-100,764,1915,2679,23,2702,661,1700,2361,18,2379,1.1558245083207261,1.1264705882352941,1.1346886912325287,1.2777777777777777,1.135771332492644
Usera,2007,85-100,915,2180,3095,19,3114,661,1700,2361,18,2379,1.384266263237519,1.2823529411764707,1.3108852181279118,1.0555555555555556,1.308953341740227
Usera,2008,85-100,904,2129,3033,20,3053,661,1700,2361,18,2379,1.367624810892587,1.2523529411764707,1.2846251588310038,1.1111111111111112,1.2833123160992013
Usera,2009,85-100,969,2307,3276,20,3296,661,1700,2361,18,2379,1.4659606656580937,1.3570588235294119,1.3875476493011436,1.1111111111111112,1.385456073980664
Usera,2010,85-100,1031,2443,3474,20,3494,661,1700,2361,18,2379,1.5597579425113464,1.4370588235294117,1.47141041931385,1.1111111111111112,1.4686843211433376
Usera,2011,85-100,1107,2525,3632,15,3647,661,1700,2361,18,2379,1.674735249621785,1.4852941176470589,1.5383312155866158,0.8333333333333334,1.5329970575872216
Usera,2012,85-100,1178,2683,3861,19,3880,661,1700,2361,18,2379,1.7821482602118004,1.578235294117647,1.6353240152477764,1.0555555555555556,1.6309373686422868
Usera,2013,85-100,1231,2822,4053,22,4075,661,1700,2361,18,2379,1.8623298033282905,1.66,1.7166454891994918,1.2222222222222223,1.7129045817570407
Usera,2014,85-100,1318,2902,4220,27,4247,661,1700,2361,18,2379,1.993948562783661,1.7070588235294117,1.7873782295637441,1.5,1.7852038671710804
Usera,2015,85-100,1391,3046,4437,26,4463,661,1700,2361,18,2379,2.104387291981846,1.791764705882353,1.8792884371029226,1.4444444444444444,1.8759983186212694
Usera,2016,85-100,1477,3191,4668,27,4695,661,1700,2361,18,2379,2.2344931921331317,1.8770588235294117,1.97712833545108,1.5,1.9735182849936947
Usera,2017,85-100,1593,3350,4943,31,4974,661,1700,2361,18,2379,2.409984871406959,1.9705882352941178,2.0936044049131723,1.7222222222222223,2.090794451450189
Usera,2004,Total,51436,57084,108520,21286,129806,51436,57084,108520,21286,129806,1.0,1.0,1.0,1.0,1.0
Usera,2005,Total,51291,56976,108267,25220,133487,51436,57084,108520,21286,129806,0.997180962749825,0.9981080512928316,0.9976686325101364,1.1848163111904537,1.028357703033758
Usera,2006,Total,50973,56964,107937,29396,137333,51436,57084,108520,21286,129806,0.9909985224356482,0.9978978347698129,0.994627718392923,1.381001597293996,1.057986533750366
Usera,2007,Total,50266,56385,106651,29643,136294,51436,57084,108520,21286,129806,0.9772532856365191,0.9877548875341602,0.982777368227055,1.3926054683829747,1.0499822812504815
Usera,2008,Total,50407,56621,107028,33034,140062,51436,57084,108520,21286,129806,0.9799945563418617,0.9918891458201948,0.9862513822336897,1.5519120548717467,1.0790102152442875
Usera,2009,Total,50490,56855,107345,34611,141956,51436,57084,108520,21286,129806,0.9816082121471343,0.9959883680190597,0.9891725027644673,1.6259983087475336,1.0936012202825756
Usera,2010,Total,50513,56928,107441,34974,142415,51436,57084,108520,21286,129806,0.9820553697799207,0.9972671852007567,0.9900571323258386,1.6430517711171662,1.0971372663821395
Usera,2011,Total,50564,57020,107584,33725,141309,51436,57084,108520,21286,129806,0.9830468932265339,0.9988788452105669,0.991374861776631,1.5843747063797802,1.0886168590049767
Usera,2012,Total,50578,57325,107903,30737,138640,51436,57084,108520,21286,129806,0.9833190761334474,1.0042218485039591,0.9943144120899373,1.4440007516677629,1.068055405759364
Usera,2013,Total,50785,57730,108515,28109,136624,51436,57084,108520,21286,129806,0.9873434948285248,1.0113166561558404,0.9999539255436786,1.320539321619844,1.052524536616181
Usera,2014,Total,50773,57787,108560,25594,134154,51436,57084,108520,21286,129806,0.9871101951940275,1.0123151846401794,1.0003685956505712,1.202386545147045,1.0334961403941265
Usera,2015,Total,50921,58296,109217,23818,133035,51436,57084,108520,21286,129806,0.9899875573528268,1.0212318688248896,1.0064227792112053,1.118951423470826,1.0248755835631636
Usera,2016,Total,51202,58523,109725,24675,134400,51436,57084,108520,21286,129806,0.9954506571273039,1.0252084647186601,1.011103943973461,1.1592126280184158,1.0353912762121935
Usera,2017,Total,50952,58227,109179,26010,135189,51436,57084,108520,21286,129806,0.9905902480752781,1.0200231238175321,1.0060726133431626,1.2219299069811143,1.0414695776774572
Vicálvaro,2004,0-24,4300,4036,8336,1510,9846,4300,4036,8336,1510,9846,1.0,1.0,1.0,1.0,1.0
Vicálvaro,2005,0-24,4306,4011,8317,1796,10113,4300,4036,8336,1510,9846,1.0013953488372094,0.9938057482656095,0.9977207293666027,1.1894039735099338,1.0271176112126752
Vicálvaro,2006,0-24,4301,3990,8291,1963,10254,4300,4036,8336,1510,9846,1.0002325581395348,0.9886025768087215,0.9946017274472169,1.3,1.0414381474710543
Vicálvaro,2007,0-24,4006,3745,7751,1898,9649,4300,4036,8336,1510,9846,0.9316279069767441,0.9278989098116948,0.9298224568138196,1.256953642384106,0.9799918748730448
Vicálvaro,2008,0-24,3964,3760,7724,2411,10135,4300,4036,8336,1510,9846,0.9218604651162791,0.931615460852329,0.9265834932821497,1.5966887417218543,1.02935202112533
Vicálvaro,2009,0-24,4050,3788,7838,2476,10314,4300,4036,8336,1510,9846,0.9418604651162791,0.9385530227948464,0.9402591170825336,1.6397350993377484,1.0475319926873858
Vicálvaro,2010,0-24,4107,3844,7951,2407,10358,4300,4036,8336,1510,9846,0.9551162790697675,0.9524281466798811,0.9538147792706334,1.5940397350993378,1.0520008125126956
Vicálvaro,2011,0-24,4255,4013,8268,2295,10563,4300,4036,8336,1510,9846,0.9895348837209302,0.9943012884043607,0.9918426103646834,1.5198675496688743,1.0728214503351614
Vicálvaro,2012,0-24,4408,4176,8584,1983,10567,4300,4036,8336,1510,9846,1.0251162790697674,1.0346878097125867,1.0297504798464492,1.3132450331125827,1.073227706682917
Vicálvaro,2013,0-24,4530,4343,8873,1744,10617,4300,4036,8336,1510,9846,1.0534883720930233,1.0760654112983152,1.0644193857965452,1.1549668874172185,1.0783059110298598
Vicálvaro,2014,0-24,4687,4556,9243,1540,10783,4300,4036,8336,1510,9846,1.09,1.1288404360753221,1.1088051823416507,1.0198675496688743,1.0951655494617103
Vicálvaro,2015,0-24,4943,4763,9706,1350,11056,4300,4036,8336,1510,9846,1.1495348837209303,1.1801288404360752,1.1643474088291748,0.8940397350993378,1.1228925451960188
Vicálvaro,2016,0-24,5153,4974,10127,1287,11414,4300,4036,8336,1510,9846,1.1983720930232558,1.232408325074331,1.2148512476007678,0.8523178807947019,1.15925248832013
Vicálvaro,2017,0-24,5370,5214,10584,1269,11853,4300,4036,8336,1510,9846,1.2488372093023257,1.2918731417244798,1.2696737044145874,0.8403973509933775,1.2038391224862888
Vicálvaro,2004,25-39,8441,8286,16727,2830,19557,8441,8286,16727,2830,19557,1.0,1.0,1.0,1.0,1.0
Vicálvaro,2005,25-39,8447,8472,16919,3548,20467,8441,8286,16727,2830,19557,1.0007108162539984,1.0224475018102823,1.0114784480181742,1.2537102473498234,1.046530653985785
Vicálvaro,2006,25-39,8417,8427,16844,4256,21100,8441,8286,16727,2830,19557,0.9971567349840066,1.0170166545981174,1.0069946792610749,1.503886925795053,1.0788975814286446
Vicálvaro,2007,25-39,8022,8017,16039,4532,20571,8441,8286,16727,2830,19557,0.9503613315957825,0.9675356022206131,0.9588688946015425,1.6014134275618375,1.051848443012732
Vicálvaro,2008,25-39,7988,8049,16037,5092,21129,8441,8286,16727,2830,19557,0.9463333728231252,0.9713975380159305,0.9587493274346864,1.7992932862190814,1.080380426445774
Vicálvaro,2009,25-39,7668,7729,15397,5351,20748,8441,8286,16727,2830,19557,0.9084231726098804,0.9327781800627565,0.9204878340407724,1.8908127208480565,1.0608989108759013
Vicálvaro,2010,25-39,7244,7336,14580,5377,19957,8441,8286,16727,2830,19557,0.8581921573273309,0.8853487810765146,0.871644646380104,1.9,1.0204530347190264
Vicálvaro,2011,25-39,6820,6973,13793,5223,19016,8441,8286,16727,2830,19557,0.8079611420447814,0.8415399468983829,0.8245949662222753,1.845583038869258,0.9723372705425167
Vicálvaro,2012,25-39,6396,6562,12958,4656,17614,8441,8286,16727,2830,19557,0.757730126762232,0.791938209027275,0.7746756740599031,1.6452296819787986,0.9006493838523291
Vicálvaro,2013,25-39,5865,6151,12016,4113,16129,8441,8286,16727,2830,19557,0.6948228882833788,0.7423364711561671,0.718359538470736,1.453356890459364,0.8247174924579435
Vicálvaro,2014,25-39,5414,5750,11164,3517,14681,8441,8286,16727,2830,19557,0.6413931998578367,0.6939415882210959,0.6674239253900879,1.242756183745583,0.7506775067750677
Vicálvaro,2015,25-39,5032,5354,10386,3065,13451,8441,8286,16727,2830,19557,0.5961378983532757,0.646150132754043,0.6209122974831112,1.0830388692579505,0.6877844250140615
Vicálvaro,2016,25-39,4695,4982,9677,3020,12697,8441,8286,16727,2830,19557,0.5562137187537022,0.6012551291334781,0.5785257368326657,1.0671378091872792,0.6492304545686967
Vicálvaro,2017,25-39,4460,4583,9043,2865,11908,8441,8286,16727,2830,19557,0.5283734154721005,0.5531016171856142,0.5406229449393196,1.0123674911660778,0.608886843585417
Vicálvaro,2004,40-64,7806,8159,15965,1263,17228,7806,8159,15965,1263,17228,1.0,1.0,1.0,1.0,1.0
Vicálvaro,2005,40-64,8281,8504,16785,1624,18409,7806,8159,15965,1263,17228,1.060850627722265,1.0422845937002083,1.0513623551518947,1.285827395091053,1.0685511957278848
Vicálvaro,2006,40-64,8495,8811,17306,1994,19300,7806,8159,15965,1263,17228,1.0882654368434537,1.0799117538914083,1.0839962417788913,1.5787806809184481,1.1202693289993035
Vicálvaro,2007,40-64,8495,8809,17304,2110,19414,7806,8159,15965,1263,17228,1.0882654368434537,1.0796666258119867,1.0838709677419356,1.6706254948535233,1.1268864638959832
Vicálvaro,2008,40-64,8696,9015,17711,2318,20029,7806,8159,15965,1263,17228,1.1140148603638227,1.104914817992401,1.109364234262449,1.8353127474267616,1.1625841653122824
Vicálvaro,2009,40-64,9042,9324,18366,2591,20957,7806,8159,15965,1263,17228,1.1583397386625673,1.1427871062630224,1.150391481365487,2.0514647664291368,1.2164499651729743
Vicálvaro,2010,40-64,9440,9677,19117,2817,21934,7806,8159,15965,1263,17228,1.2093261593645914,1.1860522122809167,1.1974318822424053,2.2304038004750595,1.2731599721383793
Vicálvaro,2011,40-64,9787,10065,19852,2944,22796,7806,8159,15965,1263,17228,1.2537791442480144,1.2336070596886874,1.2434700908236769,2.3309580364212192,1.3231947991641513
Vicálvaro,2012,40-64,10239,10443,20682,2764,23446,7806,8159,15965,1263,17228,1.3116833205226748,1.2799362666993503,1.2954588161603509,2.1884402216943784,1.3609240770838171
Vicálvaro,2013,40-64,10739,10967,21706,2647,24353,7806,8159,15965,1263,17228,1.375736612861901,1.3441598235077827,1.3595991230817412,2.0958036421219317,1.4135709310424889
Vicálvaro,2014,40-64,11150,11435,22585,2437,25022,7806,8159,15965,1263,17228,1.4283884191647451,1.4015197940924133,1.4146570623238335,1.9295328582739508,1.452403064778268
Vicálvaro,2015,40-64,11570,11940,23510,2333,25843,7806,8159,15965,1263,17228,1.4821931847296952,1.4634146341463414,1.4725963044159098,1.8471892319873318,1.5000580450429533
Vicálvaro,2016,40-64,11991,12422,24413,2423,26836,7806,8159,15965,1263,17228,1.5361260568793236,1.5224905012869223,1.5291575321014719,1.9184481393507522,1.5576967726956117
Vicálvaro,2017,40-64,12305,12913,25218,2536,27754,7806,8159,15965,1263,17228,1.5763515244683577,1.5826694447849001,1.5795803319761978,2.0079176563737136,1.6109821221267704
Vicálvaro,2004,65-84,3244,3682,6926,116,7042,3244,3682,6926,116,7042,1.0,1.0,1.0,1.0,1.0
Vicálvaro,2005,65-84,3298,3762,7060,137,7197,3244,3682,6926,116,7042,1.0166461159062885,1.0217273221075502,1.0193473866589662,1.1810344827586208,1.022010792388526
Vicálvaro,2006,65-84,3489,3989,7478,167,7645,3244,3682,6926,116,7042,1.0755240443896423,1.083378598587724,1.0796996823563385,1.4396551724137931,1.0856290826469752
Vicálvaro,2007,65-84,3556,4107,7663,146,7809,3244,3682,6926,116,7042,1.0961775585696671,1.1154263986963606,1.106410626624314,1.2586206896551724,1.1089179210451576
Vicálvaro,2008,65-84,3568,4196,7764,149,7913,3244,3682,6926,116,7042,1.0998766954377313,1.1395980445410103,1.1209933583598037,1.2844827586206897,1.1236864527122976
Vicálvaro,2009,65-84,3664,4372,8036,150,8186,3244,3682,6926,116,7042,1.1294697903822442,1.1873981531776208,1.1602656656078545,1.293103448275862,1.1624538483385403
Vicálvaro,2010,65-84,3733,4496,8229,167,8396,3244,3682,6926,116,7042,1.150739827373613,1.2210755024443238,1.188131677736067,1.4396551724137931,1.1922749218971882
Vicálvaro,2011,65-84,3803,4627,8430,184,8614,3244,3682,6926,116,7042,1.1723181257706534,1.2566539923954372,1.2171527577245163,1.5862068965517242,1.2232320363533087
Vicálvaro,2012,65-84,3791,4702,8493,165,8658,3244,3682,6926,116,7042,1.1686189889025893,1.2770233568712657,1.226248917123881,1.4224137931034482,1.2294802612894065
Vicálvaro,2013,65-84,3823,4760,8583,172,8755,3244,3682,6926,116,7042,1.1784833538840938,1.2927756653992395,1.239243430551545,1.4827586206896552,1.2432547571712582
Vicálvaro,2014,65-84,3833,4825,8658,155,8813,3244,3682,6926,116,7042,1.1815659679408137,1.310429114611624,1.2500721917412647,1.3362068965517242,1.2514910536779325
Vicálvaro,2015,65-84,3793,4889,8682,146,8828,3244,3682,6926,116,7042,1.1692355117139335,1.3278109722976643,1.253537395321975,1.2586206896551724,1.253621130360693
Vicálvaro,2016,65-84,3791,4929,8720,168,8888,3244,3682,6926,116,7042,1.1686189889025893,1.3386746333514394,1.2590239676580999,1.4482758620689655,1.2621414370917352
Vicálvaro,2017,65-84,3794,4892,8686,202,8888,3244,3682,6926,116,7042,1.1695437731196054,1.3286257468766975,1.2541149292520937,1.7413793103448276,1.2621414370917352
Vicálvaro,2004,85-100,155,376,531,10,541,155,376,531,10,541,1.0,1.0,1.0,1.0,1.0
Vicálvaro,2005,85-100,149,379,528,9,537,155,376,531,10,541,0.9612903225806452,1.0079787234042554,0.9943502824858758,0.9,0.9926062846580407
Vicálvaro,2006,85-100,159,404,563,10,573,155,376,531,10,541,1.0258064516129033,1.074468085106383,1.0602636534839924,1.0,1.0591497227356748
Vicálvaro,2007,85-100,208,457,665,10,675,155,376,531,10,541,1.3419354838709678,1.2154255319148937,1.2523540489642184,1.0,1.2476894639556377
Vicálvaro,2008,85-100,210,441,651,7,658,155,376,531,10,541,1.3548387096774193,1.172872340425532,1.2259887005649717,0.7,1.2162661737523106
Vicálvaro,2009,85-100,225,494,719,8,727,155,376,531,10,541,1.4516129032258065,1.3138297872340425,1.3540489642184557,0.8,1.343807763401109
Vicálvaro,2010,85-100,242,530,772,10,782,155,376,531,10,541,1.5612903225806452,1.4095744680851063,1.4538606403013183,1.0,1.44547134935305
Vicálvaro,2011,85-100,270,569,839,9,848,155,376,531,10,541,1.7419354838709677,1.5132978723404256,1.5800376647834276,0.9,1.567467652495379
Vicálvaro,2012,85-100,290,611,901,4,905,155,376,531,10,541,1.8709677419354838,1.625,1.6967984934086628,0.4,1.6728280961182995
Vicálvaro,2013,85-100,302,663,965,8,973,155,376,531,10,541,1.9483870967741936,1.7632978723404256,1.817325800376648,0.8,1.798521256931608
Vicálvaro,2014,85-100,352,700,1052,7,1059,155,376,531,10,541,2.270967741935484,1.8617021276595744,1.9811676082862524,0.7,1.9574861367837337
Vicálvaro,2015,85-100,414,756,1170,9,1179,155,376,531,10,541,2.670967741935484,2.0106382978723403,2.2033898305084745,0.9,2.1792975970425137
Vicálvaro,2016,85-100,464,799,1263,11,1274,155,376,531,10,541,2.9935483870967743,2.125,2.378531073446328,1.1,2.354898336414048
Vicálvaro,2017,85-100,506,880,1386,9,1395,155,376,531,10,541,3.264516129032258,2.3404255319148937,2.610169491525424,0.9,2.578558225508318
Vicálvaro,2004,Total,27245,27689,54934,6375,61309,27245,27689,54934,6375,61309,1.0,1.0,1.0,1.0,1.0
Vicálvaro,2005,Total,27944,28419,56363,7881,64244,27245,27689,54934,6375,61309,1.0256560836850799,1.026364260175521,1.0260130338224052,1.236235294117647,1.0478722536658565
Vicálvaro,2006,Total,28537,29095,57632,9297,66929,27245,27689,54934,6375,61309,1.0474215452376583,1.0507782874065514,1.0491134816325045,1.4583529411764706,1.0916668025901581
Vicálvaro,2007,Total,27979,28709,56688,9554,66242,27245,27689,54934,6375,61309,1.0269407230684529,1.0368377333959333,1.031929224159901,1.4986666666666666,1.0804612699603646
Vicálvaro,2008,Total,28400,29337,57737,11035,68772,27245,27689,54934,6375,61309,1.0423930996513122,1.059518220231861,1.05102486620308,1.7309803921568627,1.121727641944902
Vicálvaro,2009,Total,28794,29743,58537,11742,70279,27245,27689,54934,6375,61309,1.056854468709855,1.0741810827404383,1.0655877962646085,1.8418823529411765,1.146308046126996
Vicálvaro,2010,Total,29009,29935,58944,11976,70920,27245,27689,54934,6375,61309,1.064745824922004,1.0811152443208494,1.072996686933411,1.8785882352941177,1.1567632810843433
Vicálvaro,2011,Total,29231,30416,59647,11825,71472,27245,27689,54934,6375,61309,1.0728941090108277,1.0984867636967748,1.0857938617249792,1.8549019607843138,1.1657668531536969
Vicálvaro,2012,Total,29514,30708,60222,10703,70925,27245,27689,54934,6375,61309,1.0832813360249587,1.1090324677669834,1.0962609677067026,1.6789019607843136,1.1568448351791742
Vicálvaro,2013,Total,29657,31106,60763,9794,70557,27245,27689,54934,6375,61309,1.0885300055055973,1.123406406876377,1.106109149160811,1.5363137254901962,1.1508424537996054
Vicálvaro,2014,Total,29794,31399,61193,8691,69884,27245,27689,54934,6375,61309,1.0935584510919434,1.1339882263714833,1.1139367240688827,1.3632941176470588,1.139865272635339
Vicálvaro,2015,Total,29968,31697,61665,7795,69460,27245,27689,54934,6375,61309,1.0999449440264268,1.1447506229910795,1.1225288528051844,1.2227450980392156,1.1329494853936617
Vicálvaro,2016,Total,30151,31964,62115,7843,69958,27245,27689,54934,6375,61309,1.1066617728023491,1.1543934414388386,1.130720500964794,1.2302745098039216,1.1410722732388394
Vicálvaro,2017,Total,30300,32104,62404,7799,70203,27245,27689,54934,6375,61309,1.1121306661772803,1.159449600924555,1.1359813594495212,1.223372549019608,1.1450684238855633
Villa de Vallecas,2004,0-24,5564,5306,10870,1704,12574,5564,5306,10870,1704,12574,1.0,1.0,1.0,1.0,1.0
Villa de Vallecas,2005,0-24,5337,5088,10425,1948,12373,5564,5306,10870,1704,12574,0.9592020129403307,0.9589144364869958,0.9590616375344986,1.1431924882629108,0.9840146333704469
Villa de Vallecas,2006,0-24,5158,4900,10058,2175,12233,5564,5306,10870,1704,12574,0.9270309130122214,0.9234828496042217,0.9252989880404784,1.2764084507042253,0.972880547160808
Villa de Vallecas,2007,0-24,4913,4598,9511,2134,11645,5564,5306,10870,1704,12574,0.8829978432782171,0.8665661515265737,0.8749770009199632,1.2523474178403755,0.9261173850803245
Villa de Vallecas,2008,0-24,5120,4795,9915,2765,12680,5564,5306,10870,1704,12574,0.9202012940330697,0.9036939313984169,0.9121435142594296,1.6226525821596245,1.0084300938444408
Villa de Vallecas,2009,0-24,5355,5042,10397,3065,13462,5564,5306,10870,1704,12574,0.9624370956146657,0.9502450056539766,0.9564857405703772,1.7987089201877935,1.0706219182439956
Villa de Vallecas,2010,0-24,5701,5282,10983,3058,14041,5564,5306,10870,1704,12574,1.0246225736879941,0.9954768186958161,1.010395584176633,1.7946009389671362,1.1166693176395737
Villa de Vallecas,2011,0-24,5763,5411,11174,2957,14131,5564,5306,10870,1704,12574,1.035765636232926,1.0197889182058046,1.0279668813247471,1.7353286384976525,1.1238269444886273
Villa de Vallecas,2012,0-24,5872,5509,11381,2495,13876,5564,5306,10870,1704,12574,1.055355859094177,1.0382585751978892,1.0470101195952162,1.4642018779342723,1.103547001749642
Villa de Vallecas,2013,0-24,5992,5588,11580,2267,13847,5564,5306,10870,1704,12574,1.0769230769230769,1.0531473803241613,1.0653173873045079,1.3303990610328638,1.1012406553205025
Villa de Vallecas,2014,0-24,6119,5683,11802,1955,13757,5564,5306,10870,1704,12574,1.099748382458663,1.0710516396532228,1.085740570377185,1.147300469483568,1.0940830284714491
Villa de Vallecas,2015,0-24,6232,5781,12013,1668,13681,5564,5306,10870,1704,12574,1.1200575125808772,1.0895212966453072,1.105151793928243,0.9788732394366197,1.0880388102433594
Villa de Vallecas,2016,0-24,6317,5930,12247,1630,13877,5564,5306,10870,1704,12574,1.135334291876348,1.1176027139087825,1.1266789328426863,0.9565727699530516,1.1036265309368538
Villa de Vallecas,2017,0-24,6438,6100,12538,1668,14206,5564,5306,10870,1704,12574,1.1570812365204888,1.1496419148134187,1.1534498620055198,0.9788732394366197,1.1297916335295053
Villa de Vallecas,2004,25-39,7448,7402,14850,2995,17845,7448,7402,14850,2995,17845,1.0,1.0,1.0,1.0,1.0
Villa de Vallecas,2005,25-39,7242,7211,14453,3603,18056,7448,7402,14850,2995,17845,0.9723415682062299,0.9741961631991354,0.9732659932659933,1.2030050083472454,1.0118240403474363
Villa de Vallecas,2006,25-39,7087,7068,14155,4272,18427,7448,7402,14850,2995,17845,0.951530612244898,0.9548770602539854,0.9531986531986532,1.4263772954924874,1.0326141776407958
Villa de Vallecas,2007,25-39,6758,6838,13596,4609,18205,7448,7402,14850,2995,17845,0.9073576799140709,0.9238043771953526,0.9155555555555556,1.53889816360601,1.0201737181283272
Villa de Vallecas,2008,25-39,7435,7652,15087,5322,20409,7448,7402,14850,2995,17845,0.9982545649838883,1.0337746554985139,1.015959595959596,1.7769616026711186,1.1436817035584197
Villa de Vallecas,2009,25-39,8868,9177,18045,6002,24047,7448,7402,14850,2995,17845,1.1906552094522018,1.2398000540394487,1.215151515151515,2.004006677796327,1.3475483328663491
Villa de Vallecas,2010,25-39,10410,10661,21071,6484,27555,7448,7402,14850,2995,17845,1.3976906552094521,1.4402864090786274,1.418922558922559,2.1649415692821368,1.544130008405716
Villa de Vallecas,2011,25-39,11228,11498,22726,6585,29311,7448,7402,14850,2995,17845,1.5075187969924813,1.553363955687652,1.5303703703703704,2.1986644407345577,1.6425329223872234
Villa de Vallecas,2012,25-39,11823,12154,23977,6095,30072,7448,7402,14850,2995,17845,1.587406015037594,1.6419886517157525,1.6146127946127946,2.035058430717863,1.6851779209862707
Villa de Vallecas,2013,25-39,12114,12477,24591,5634,30225,7448,7402,14850,2995,17845,1.6264769065520945,1.6856255066198325,1.6559595959595959,1.881135225375626,1.6937517511908098
Villa de Vallecas,2014,25-39,12027,12508,24535,5010,29545,7448,7402,14850,2995,17845,1.614795918367347,1.6898135639016483,1.6521885521885522,1.672787979966611,1.6556458391706361
Villa de Vallecas,2015,25-39,11640,12252,23892,4482,28374,7448,7402,14850,2995,17845,1.5628356605800215,1.6552283166711699,1.6088888888888888,1.4964941569282137,1.5900252171476603
Villa de Vallecas,2016,25-39,11475,12116,23591,4451,28042,7448,7402,14850,2995,17845,1.5406820622986037,1.6368549040799785,1.5886195286195286,1.486143572621035,1.5714205659848697
Villa de Vallecas,2017,25-39,11119,11636,22755,4392,27147,7448,7402,14850,2995,17845,1.4928839957035447,1.5720075655228316,1.5323232323232323,1.4664440734557596,1.5212664611936118
Villa de Vallecas,2004,40-64,9192,9612,18804,1250,20054,9192,9612,18804,1250,20054,1.0,1.0,1.0,1.0,1.0
Villa de Vallecas,2005,40-64,9298,9867,19165,1590,20755,9192,9612,18804,1250,20054,1.011531766753699,1.026529338327091,1.0191980429695808,1.272,1.0349556198264684
Villa de Vallecas,2006,40-64,9358,9917,19275,1926,21201,9192,9612,18804,1250,20054,1.018059181897302,1.031731169371619,1.0250478621569878,1.5408,1.0571955719557196
Villa de Vallecas,2007,40-64,9487,10153,19640,2081,21721,9192,9612,18804,1250,20054,1.0320931244560487,1.0562838119017894,1.0444586258242927,1.6648,1.0831255609853396
Villa de Vallecas,2008,40-64,9838,10506,20344,2587,22931,9192,9612,18804,1250,20054,1.070278503046127,1.0930087390761547,1.081897468623697,2.0696,1.1434626508427246
Villa de Vallecas,2009,40-64,10571,11248,21819,3018,24837,9192,9612,18804,1250,20054,1.1500217580504786,1.1702039117769454,1.160338225909381,2.4144,1.2385060337089857
Villa de Vallecas,2010,40-64,11217,11965,23182,3307,26489,9192,9612,18804,1250,20054,1.2203002610966058,1.2447981689554724,1.232822803658796,2.6456,1.3208836142415479
Villa de Vallecas,2011,40-64,11752,12535,24287,3573,27860,9192,9612,18804,1250,20054,1.278503046127067,1.3040990428630879,1.2915868964050201,2.8584,1.3892490276254115
Villa de Vallecas,2012,40-64,12335,13114,25449,3399,28848,9192,9612,18804,1250,20054,1.3419277632724107,1.3643362463587183,1.3533822590938098,2.7192,1.4385160067816893
Villa de Vallecas,2013,40-64,12907,13783,26690,3373,30063,9192,9612,18804,1250,20054,1.4041557876414272,1.4339367457344985,1.4193788555626463,2.6984,1.499102423456667
Villa de Vallecas,2014,40-64,13537,14341,27878,3235,31113,9192,9612,18804,1250,20054,1.4726936466492602,1.4919891801914273,1.4825569027866412,2.588,1.5514610551510921
Villa de Vallecas,2015,40-64,14307,15027,29334,3157,32491,9192,9612,18804,1250,20054,1.556462140992167,1.5633583021223472,1.5599872367581367,2.5256,1.6201755260795851
Villa de Vallecas,2016,40-64,15118,15815,30933,3257,34190,9192,9612,18804,1250,20054,1.6446910356832027,1.6453391593841031,1.645022335673261,2.6056,1.7048967786975167
Villa de Vallecas,2017,40-64,15875,16746,32621,3495,36116,9192,9612,18804,1250,20054,1.7270452567449956,1.7421972534332084,1.734790470112742,2.796,1.8009374688341477
Villa de Vallecas,2004,65-84,3219,4241,7460,108,7568,3219,4241,7460,108,7568,1.0,1.0,1.0,1.0,1.0
Villa de Vallecas,2005,65-84,3209,4269,7478,116,7594,3219,4241,7460,108,7568,0.9968934451693072,1.0066022164583825,1.0024128686327078,1.0740740740740742,1.0034355179704018
Villa de Vallecas,2006,65-84,3298,4406,7704,153,7857,3219,4241,7460,108,7568,1.0245417831624728,1.038905918415468,1.0327077747989277,1.4166666666666667,1.0381871035940804
Villa de Vallecas,2007,65-84,3334,4461,7795,137,7932,3219,4241,7460,108,7568,1.0357253805529667,1.0518745578872908,1.0449061662198391,1.2685185185185186,1.0480972515856237
Villa de Vallecas,2008,65-84,3380,4568,7948,146,8094,3219,4241,7460,108,7568,1.0500155327741534,1.0771044564961094,1.0654155495978552,1.3518518518518519,1.0695031712473573
Villa de Vallecas,2009,65-84,3538,4719,8257,167,8424,3219,4241,7460,108,7568,1.0990990990990992,1.1127092666823861,1.1068364611260053,1.5462962962962963,1.113107822410148
Villa de Vallecas,2010,65-84,3690,4902,8592,185,8777,3219,4241,7460,108,7568,1.146318732525629,1.1558594671068145,1.1517426273458444,1.712962962962963,1.1597515856236786
Villa de Vallecas,2011,65-84,3816,5052,8868,207,9075,3219,4241,7460,108,7568,1.1854613233923579,1.191228483848149,1.1887399463806971,1.9166666666666667,1.1991279069767442
Villa de Vallecas,2012,65-84,3943,5185,9128,217,9345,3219,4241,7460,108,7568,1.224914569742156,1.2225890120254657,1.2235924932975872,2.009259259259259,1.2348044397463003
Villa de Vallecas,2013,65-84,4090,5352,9442,212,9654,3219,4241,7460,108,7568,1.2705809257533396,1.261966517330818,1.2656836461126006,1.962962962962963,1.2756342494714588
Villa de Vallecas,2014,65-84,4272,5526,9798,200,9998,3219,4241,7460,108,7568,1.3271202236719477,1.3029945767507662,1.3134048257372655,1.8518518518518519,1.3210887949260042
Villa de Vallecas,2015,65-84,4436,5716,10152,215,10367,3219,4241,7460,108,7568,1.378067722895309,1.3477953312897901,1.360857908847185,1.9907407407407407,1.3698467230443974
Villa de Vallecas,2016,65-84,4581,5852,10433,247,10680,3219,4241,7460,108,7568,1.4231127679403541,1.3798632398019335,1.3985254691689009,2.287037037037037,1.4112050739957718
Villa de Vallecas,2017,65-84,4723,6010,10733,294,11027,3219,4241,7460,108,7568,1.4672258465361914,1.4171186041028059,1.4387399463806971,2.7222222222222223,1.457056025369979
Villa de Vallecas,2004,85-100,187,519,706,9,715,187,519,706,9,715,1.0,1.0,1.0,1.0,1.0
Villa de Vallecas,2005,85-100,188,523,711,9,720,187,519,706,9,715,1.0053475935828877,1.0077071290944124,1.0070821529745042,1.0,1.006993006993007
Villa de Vallecas,2006,85-100,195,533,728,11,739,187,519,706,9,715,1.0427807486631016,1.0269749518304432,1.0311614730878187,1.2222222222222223,1.0335664335664336
Villa de Vallecas,2007,85-100,259,618,877,10,887,187,519,706,9,715,1.3850267379679144,1.1907514450867052,1.2422096317280453,1.1111111111111112,1.2405594405594405
Villa de Vallecas,2008,85-100,259,652,911,10,921,187,519,706,9,715,1.3850267379679144,1.25626204238921,1.2903682719546743,1.1111111111111112,1.288111888111888
Villa de Vallecas,2009,85-100,277,708,985,7,992,187,519,706,9,715,1.481283422459893,1.3641618497109826,1.3951841359773371,0.7777777777777778,1.3874125874125873
Villa de Vallecas,2010,85-100,300,775,1075,15,1090,187,519,706,9,715,1.6042780748663101,1.4932562620423893,1.5226628895184136,1.6666666666666667,1.5244755244755244
Villa de Vallecas,2011,85-100,343,834,1177,18,1195,187,519,706,9,715,1.8342245989304813,1.606936416184971,1.6671388101983002,2.0,1.6713286713286712
Villa de Vallecas,2012,85-100,367,880,1247,12,1259,187,519,706,9,715,1.9625668449197862,1.6955684007707128,1.7662889518413598,1.3333333333333333,1.760839160839161
Villa de Vallecas,2013,85-100,416,974,1390,12,1402,187,519,706,9,715,2.2245989304812834,1.8766859344894027,1.9688385269121813,1.3333333333333333,1.9608391608391609
Villa de Vallecas,2014,85-100,449,1066,1515,20,1535,187,519,706,9,715,2.4010695187165774,2.0539499036608864,2.1458923512747874,2.2222222222222223,2.1468531468531467
Villa de Vallecas,2015,85-100,468,1103,1571,20,1591,187,519,706,9,715,2.5026737967914436,2.1252408477842004,2.225212464589235,2.2222222222222223,2.2251748251748253
Villa de Vallecas,2016,85-100,528,1169,1697,25,1722,187,519,706,9,715,2.823529411764706,2.2524084778420037,2.403682719546742,2.7777777777777777,2.4083916083916086
Villa de Vallecas,2017,85-100,568,1223,1791,29,1820,187,519,706,9,715,3.037433155080214,2.3564547206165702,2.536827195467422,3.2222222222222223,2.5454545454545454
Villa de Vallecas,2004,Total,28605,29847,58452,6951,65403,28605,29847,58452,6951,65403,1.0,1.0,1.0,1.0,1.0
Villa de Vallecas,2005,Total,28258,29693,57951,8293,66244,28605,29847,58452,6951,65403,0.9878692536269883,0.9948403524642343,0.9914288647095052,1.1930657459358365,1.0128587373667874
Villa de Vallecas,2006,Total,28086,29565,57651,9689,67340,28605,29847,58452,6951,65403,0.9818563188253802,0.9905518142526887,0.9862964483678917,1.3939001582506114,1.0296163784535877
Villa de Vallecas,2007,Total,27665,29358,57023,10076,67099,28605,29847,58452,6951,65403,0.9671386121307464,0.983616443863705,0.9755525901594471,1.4495756006330025,1.025931532192713
Villa de Vallecas,2008,Total,29438,31310,60748,12301,73049,28605,29847,58452,6951,65403,1.0291207830798812,1.0490166515897745,1.0392800930678163,1.7696734282837001,1.1169059523263458
Villa de Vallecas,2009,Total,32609,34521,67130,13865,80995,28605,29847,58452,6951,65403,1.1399755287537143,1.156598653130968,1.1484636967084103,1.9946770248885053,1.238398850205648
Villa de Vallecas,2010,Total,35865,37714,73579,14755,88334,28605,29847,58452,6951,65403,1.2538017829050865,1.2635775789861627,1.2587935399986314,2.122716155948784,1.3506108282494687
Villa de Vallecas,2011,Total,37813,39822,77635,15159,92794,28605,29847,58452,6951,65403,1.3219017654256249,1.3342044426575534,1.3281838089372477,2.1808372895986188,1.4188034188034189
Villa de Vallecas,2012,Total,39664,41644,81308,13844,95152,28605,29847,58452,6951,65403,1.3866107323894423,1.395249103762522,1.3910216930130705,1.9916558768522514,1.4548568108496551
Villa de Vallecas,2013,Total,41206,43338,84544,13124,97668,28605,29847,58452,6951,65403,1.4405173920643244,1.4520052266559453,1.4463833572846096,1.8880736584664077,1.4933259942204486
Villa de Vallecas,2014,Total,42363,44617,86980,11953,98933,28605,29847,58452,6951,65403,1.4809648662821184,1.494857104566623,1.4880585779785123,1.7196086893972091,1.5126676146354143
Villa de Vallecas,2015,Total,43233,45572,88805,10897,99702,28605,29847,58452,6951,65403,1.5113791295228107,1.5268536201293261,1.5192807773899952,1.5676881024313047,1.5244254850694923
Villa de Vallecas,2016,Total,44472,46902,91374,10922,102296,28605,29847,58452,6951,65403,1.5546932354483483,1.5714142124836668,1.56323136932868,1.571284707236369,1.5640872742840541
Villa de Vallecas,2017,Total,45425,47904,93329,11236,104565,28605,29847,58452,6951,65403,1.588009089320049,1.6049854256709217,1.5966776158215288,1.616458063587973,1.5987798724829136
Villaverde,2004,0-24,9182,8941,18123,5152,23275,9182,8941,18123,5152,23275,1.0,1.0,1.0,1.0,1.0
Villaverde,2005,0-24,8834,8537,17371,5958,23329,9182,8941,18123,5152,23275,0.9620997604007842,0.9548148976624539,0.9585057661535066,1.156444099378882,1.0023200859291086
Villaverde,2006,0-24,8551,8192,16743,6692,23435,9182,8941,18123,5152,23275,0.9312785885428011,0.9162286097751929,0.9238536666114882,1.298913043478261,1.00687432867884
Villaverde,2007,0-24,8024,7671,15695,6610,22305,9182,8941,18123,5152,23275,0.8738836854715748,0.8579577228497931,0.8660265960381835,1.282996894409938,0.9583243823845328
Villaverde,2008,0-24,7798,7519,15317,7548,22865,9182,8941,18123,5152,23275,0.8492703114789806,0.840957387316855,0.8451691221100259,1.4650621118012421,0.9823845327604727
Villaverde,2009,0-24,7688,7431,15119,7934,23053,9182,8941,18123,5152,23275,0.837290350686125,0.8311150877977855,0.8342437786238481,1.5399844720496894,0.9904618689581096
Villaverde,2010,0-24,7764,7539,15303,7454,22757,9182,8941,18123,5152,23275,0.8455674145066434,0.8431942735711889,0.8443966230756498,1.4468167701863355,0.9777443609022557
Villaverde,2011,0-24,7817,7758,15575,6703,22278,9182,8941,18123,5152,23275,0.8513395774341103,0.8676881780561458,0.8594051757435304,1.3010481366459627,0.9571643394199785
Villaverde,2012,0-24,8023,8024,16047,5641,21688,9182,8941,18123,5152,23275,0.8737747767370944,0.8974387652387876,0.8854494289024996,1.094914596273292,0.9318152524167562
Villaverde,2013,0-24,8233,8259,16492,4882,21374,9182,8941,18123,5152,23275,0.8966456109780004,0.9237221787272117,0.9100038624951718,0.9475931677018633,0.9183243823845327
Villaverde,2014,0-24,8446,8292,16738,4210,20948,9182,8941,18123,5152,23275,0.9198431714223481,0.9274130410468627,0.9235777740992109,0.8171583850931677,0.9000214822771214
Villaverde,2015,0-24,8742,8560,17302,3648,20950,9182,8941,18123,5152,23275,0.9520801568285776,0.9573873168549379,0.954698449484081,0.7080745341614907,0.9001074113856069
Villaverde,2016,0-24,8995,8699,17694,3580,21274,9182,8941,18123,5152,23275,0.9796340666521455,0.972933676322559,0.9763284224466148,0.6948757763975155,0.9140279269602578
Villaverde,2017,0-24,9228,8939,18167,3662,21829,9182,8941,18123,5152,23275,1.0050098017861033,0.9997763113745666,1.0024278541080396,0.7107919254658385,0.9378732545649839
Villaverde,2004,25-39,15923,15325,31248,9866,41114,15923,15325,31248,9866,41114,1.0,1.0,1.0,1.0,1.0
Villaverde,2005,25-39,15461,15041,30502,11937,42439,15923,15325,31248,9866,41114,0.970985367079068,0.9814681892332789,0.976126472094214,1.2099128319481045,1.0322274650970473
Villaverde,2006,25-39,14850,14643,29493,14134,43627,15923,15325,31248,9866,41114,0.9326132010299567,0.9554975530179446,0.943836405529954,1.432596797080884,1.0611227319161356
Villaverde,2007,25-39,13714,13548,27262,14477,41739,15923,15325,31248,9866,41114,0.861269861207059,0.8840456769983687,0.8724398361495136,1.467362659639165,1.0152016344797392
Villaverde,2008,25-39,13308,13185,26493,15945,42438,15923,15325,31248,9866,41114,0.8357721534886642,0.8603588907014682,0.8478302611367128,1.6161564970606122,1.0322031424818796
Villaverde,2009,25-39,12572,12571,25143,16540,41683,15923,15325,31248,9866,41114,0.7895497079696037,0.8202936378466558,0.8046274961597543,1.6764646259882425,1.0138395680303547
Villaverde,2010,25-39,12100,12139,24239,16131,40370,15923,15325,31248,9866,41114,0.7599070526910758,0.7921044045676998,0.7756976446492575,1.635009122237989,0.9819039743153184
Villaverde,2011,25-39,11615,11731,23346,15312,38658,15923,15325,31248,9866,41114,0.7294479683476732,0.7654812398042414,0.7471198156682027,1.5519967565376038,0.9402636571484166
Villaverde,2012,25-39,11190,11362,22552,13620,36172,15923,15325,31248,9866,41114,0.7027570181498461,0.7414029363784665,0.721710189452125,1.3804986823434016,0.8797976358418057
Villaverde,2013,25-39,10794,11116,21910,11817,33727,15923,15325,31248,9866,41114,0.6778873327890473,0.7253507340946166,0.7011648745519713,1.1977498479627002,0.8203288417570658
Villaverde,2014,25-39,10362,10847,21209,10325,31534,15923,15325,31248,9866,41114,0.6507567669409031,0.7077977161500816,0.678731438812084,1.046523413744172,0.7669893466945567
Villaverde,2015,25-39,10072,10511,20583,9107,29690,15923,15325,31248,9866,41114,0.6325441185706211,0.6858727569331158,0.6586981566820277,0.9230691262923171,0.7221384443255339
Villaverde,2016,25-39,9681,10223,19904,9018,28922,15923,15325,31248,9866,41114,0.6079884443886202,0.6670799347471452,0.636968766001024,0.9140482465031421,0.7034586758768303
Villaverde,2017,25-39,9331,9872,19203,9040,28243,15923,15325,31248,9866,41114,0.5860076618727627,0.6441761827079935,0.6145353302611367,0.9162781269004663,0.6869436201780416
Villaverde,2004,40-64,16604,17928,34532,3977,38509,16604,17928,34532,3977,38509,1.0,1.0,1.0,1.0,1.0
Villaverde,2005,40-64,17000,18136,35136,5021,40157,16604,17928,34532,3977,38509,1.0238496747771622,1.0116019634091924,1.0174910228194138,1.2625094292180035,1.0427951907346336
Villaverde,2006,40-64,17091,18082,35173,6147,41320,16604,17928,34532,3977,38509,1.029330281859793,1.0085899152164213,1.0185624927603383,1.545637415137038,1.0729959230309798
Villaverde,2007,40-64,17354,18373,35727,6652,42379,16604,17928,34532,3977,38509,1.04516983859311,1.0248215082552432,1.0346055832271517,1.6726175509177772,1.1004959879508687
Villaverde,2008,40-64,17426,18388,35814,7207,43021,16604,17928,34532,3977,38509,1.0495061430980486,1.0256581883087907,1.0371249855206766,1.8121699773698767,1.117167415409385
Villaverde,2009,40-64,17711,18628,36339,7988,44327,16604,17928,34532,3977,38509,1.0666706817634306,1.039045069165551,1.0523282752229817,2.008549157656525,1.1510815653483601
Villaverde,2010,40-64,17945,18876,36821,8423,45244,16604,17928,34532,3977,38509,1.0807636714044808,1.0528781793842035,1.0662863431020502,2.11792808649736,1.1748941805811628
Villaverde,2011,40-64,18272,19172,37444,8751,46195,16604,17928,34532,3977,38509,1.1004577210310769,1.069388665774208,1.0843275802154524,2.2004023133014834,1.1995897063024228
Villaverde,2012,40-64,18793,19742,38535,8377,46912,16604,17928,34532,3977,38509,1.131835702240424,1.1011825078090138,1.115921464149195,2.1063615790797083,1.2182087304266536
Villaverde,2013,40-64,19359,20322,39681,7988,47669,16604,17928,34532,3977,38509,1.1659238737653577,1.1335341365461848,1.1491080736707981,2.008549157656525,1.2378664727725985
Villaverde,2014,40-64,19845,20741,40586,7545,48131,16604,17928,34532,3977,38509,1.195193929173693,1.156905399375279,1.175315649252867,1.8971586623082726,1.2498636682334
Villaverde,2015,40-64,20330,21500,41830,7100,48930,16604,17928,34532,3977,38509,1.224403758130571,1.1992414100847837,1.211340206185567,1.7852652753331657,1.2706120647121453
Villaverde,2016,40-64,20857,22036,42893,7519,50412,16604,17928,34532,3977,38509,1.256143098048663,1.2291387773315485,1.2421232480018534,1.8906210711591651,1.3090965748266639
Villaverde,2017,40-64,21284,22529,43813,7977,51790,16604,17928,34532,3977,38509,1.281859792821007,1.2566376617581436,1.2687652032897023,2.0057832537088256,1.344880417564725
Villaverde,2004,65-84,9832,12527,22359,302,22661,9832,12527,22359,302,22661,1.0,1.0,1.0,1.0,1.0
Villaverde,2005,65-84,9701,12478,22179,370,22549,9832,12527,22359,302,22661,0.9866761594792515,0.9960884489502674,0.9919495505165705,1.2251655629139073,0.9950575879263933
Villaverde,2006,65-84,9783,12738,22521,448,22969,9832,12527,22359,302,22661,0.9950162733930025,1.016843617785583,1.0072454045350865,1.4834437086092715,1.0135916332024182
Villaverde,2007,65-84,9730,12778,22508,399,22907,9832,12527,22359,302,22661,0.9896257119609438,1.020036720683324,1.0066639831835056,1.3211920529801324,1.0108556550902432
Villaverde,2008,65-84,9576,12698,22274,401,22675,9832,12527,22359,302,22661,0.9739625711960944,1.0136505148878423,0.9961983988550471,1.3278145695364238,1.0006178015092009
Villaverde,2009,65-84,9501,12771,22272,420,22692,9832,12527,22359,302,22661,0.9663344182262001,1.0194779276762194,0.9961089494163424,1.390728476821192,1.0013679890560876
Villaverde,2010,65-84,9587,12866,22453,437,22890,9832,12527,22359,302,22661,0.9750813669650122,1.027061547058354,1.0042041236191244,1.4470198675496688,1.0101054675433565
Villaverde,2011,65-84,9578,12909,22487,457,22944,9832,12527,22359,302,22661,0.9741659886086249,1.0304941326734254,1.0057247640771054,1.5132450331125828,1.0124884162217025
Villaverde,2012,65-84,9497,12861,22358,427,22785,9832,12527,22359,302,22661,0.9659275834011392,1.0266624091961363,0.9999552752806476,1.413907284768212,1.0054719562243501
Villaverde,2013,65-84,9453,12831,22284,422,22706,9832,12527,22359,302,22661,0.9614524003254679,1.0242675820228306,0.9966456460485711,1.3973509933774835,1.0019857905652885
Villaverde,2014,65-84,9377,12810,22187,422,22609,9832,12527,22359,302,22661,0.9537225386493083,1.0225912030015167,0.9923073482713896,1.3973509933774835,0.9977053086801112
Villaverde,2015,65-84,9236,12681,21917,442,22359,9832,12527,22359,302,22661,0.9393816110659072,1.0122934461563025,0.9802316740462453,1.4635761589403973,0.9866731388729535
Villaverde,2016,65-84,9050,12480,21530,469,21999,9832,12527,22359,302,22661,0.9204637917005696,0.9962481040951545,0.962923207656872,1.5529801324503312,0.9707868143506465
Villaverde,2017,65-84,8846,12277,21123,569,21692,9832,12527,22359,302,22661,0.8997152156224573,0.9800431068891196,0.9447202468804509,1.8841059602649006,0.9572393098274569
Villaverde,2004,85-100,526,1288,1814,12,1826,526,1288,1814,12,1826,1.0,1.0,1.0,1.0,1.0
Villaverde,2005,85-100,533,1328,1861,14,1875,526,1288,1814,12,1826,1.0133079847908746,1.031055900621118,1.025909592061742,1.1666666666666667,1.0268346111719606
Villaverde,2006,85-100,534,1338,1872,20,1892,526,1288,1814,12,1826,1.015209125475285,1.0388198757763976,1.031973539140022,1.6666666666666667,1.036144578313253
Villaverde,2007,85-100,661,1475,2136,12,2148,526,1288,1814,12,1826,1.2566539923954372,1.1451863354037266,1.177508269018743,1.0,1.176341730558598
Villaverde,2008,85-100,665,1459,2124,4,2128,526,1288,1814,12,1826,1.2642585551330798,1.1327639751552796,1.1708930540242557,0.3333333333333333,1.1653888280394304
Villaverde,2009,85-100,736,1576,2312,8,2320,526,1288,1814,12,1826,1.3992395437262357,1.2236024844720497,1.2745314222712238,0.6666666666666666,1.2705366922234391
Villaverde,2010,85-100,791,1682,2473,11,2484,526,1288,1814,12,1826,1.5038022813688212,1.3059006211180124,1.3632855567805953,0.9166666666666666,1.3603504928806134
Villaverde,2011,85-100,843,1814,2657,14,2671,526,1288,1814,12,1826,1.602661596958175,1.4083850931677018,1.4647188533627342,1.1666666666666667,1.4627601314348302
Villaverde,2012,85-100,913,1941,2854,12,2866,526,1288,1814,12,1826,1.7357414448669202,1.5069875776397517,1.5733186328555677,1.0,1.5695509309967142
Villaverde,2013,85-100,987,2036,3023,20,3043,526,1288,1814,12,1826,1.876425855513308,1.5807453416149069,1.6664829106945975,1.6666666666666667,1.6664841182913472
Villaverde,2014,85-100,1073,2222,3295,26,3321,526,1288,1814,12,1826,2.0399239543726235,1.7251552795031055,1.8164277839029768,2.1666666666666665,1.8187294633077766
Villaverde,2015,85-100,1203,2382,3585,31,3616,526,1288,1814,12,1826,2.2870722433460076,1.8493788819875776,1.9762954796030872,2.5833333333333335,1.9802847754654984
Villaverde,2016,85-100,1338,2521,3859,36,3895,526,1288,1814,12,1826,2.543726235741445,1.9572981366459627,2.1273428886438808,3.0,2.133077765607886
Villaverde,2017,85-100,1466,2777,4243,34,4277,526,1288,1814,12,1826,2.7870722433460076,2.156055900621118,2.339029768467475,2.8333333333333335,2.342278203723987
Villaverde,2004,Total,57586,61424,119010,21991,141001,57586,61424,119010,21991,141001,1.0,1.0,1.0,1.0,1.0
Villaverde,2005,Total,57227,61101,118328,26355,144683,57586,61424,119010,21991,141001,0.9937658458653145,0.9947414691325867,0.9942693891269642,1.1984448183347733,1.0261132899766667
Villaverde,2006,Total,56770,60745,117515,30713,148228,57586,61424,119010,21991,141001,0.9858298892091828,0.9889456889815056,0.9874380304176119,1.3966167977809103,1.0512549556386126
Villaverde,2007,Total,55407,59537,114944,31112,146056,57586,61424,119010,21991,141001,0.9621609418955996,0.969279109143006,0.9658348037980001,1.4147605838752217,1.0358508095687264
Villaverde,2008,Total,55036,59228,114264,34485,148749,57586,61424,119010,21991,141001,0.9557184037786962,0.9642485022141183,0.9601209982354424,1.568141512436906,1.054949964893866
Villaverde,2009,Total,54835,59196,114031,36410,150441,57586,61424,119010,21991,141001,0.9522279720765464,0.9637275332117738,0.9581631795647425,1.6556773225410395,1.0669498797880865
Villaverde,2010,Total,55062,59502,114564,35855,150419,57586,61424,119010,21991,141001,0.956169902406835,0.9687092992966918,0.9626417948071591,1.6304397253421854,1.0667938525258687
Villaverde,2011,Total,55090,59875,114965,34625,149590,57586,61424,119010,21991,141001,0.9566561316986768,0.9747818442302683,0.9660112595580204,1.5745077531717522,1.0609144615995632
Villaverde,2012,Total,55351,60348,115699,31259,146958,57586,61424,119010,21991,141001,0.9611884833119161,0.9824824172961709,0.9721788085034871,1.4214451366468102,1.0422479273196643
Villaverde,2013,Total,55693,60949,116642,28232,144874,57586,61424,119010,21991,141001,0.9671274268051262,0.9922668663714509,0.9801025123939164,1.2837979173298169,1.0274678902986503
Villaverde,2014,Total,55857,61215,117072,25430,142502,57586,61424,119010,21991,141001,0.9699753412287708,0.9965974212034384,0.9837156541467104,1.1563821563366832,1.0106453145722372
Villaverde,2015,Total,56251,61795,118046,22928,140974,57586,61424,119010,21991,141001,0.9768172819782586,1.00603998437093,0.9918998403495505,1.0426083397753627,0.9998085119963688
Villaverde,2016,Total,56527,62083,118610,23245,141855,57586,61424,119010,21991,141001,0.9816101135692703,1.010728705392029,0.9966389379043777,1.0570233277249783,1.0060566946333713
Villaverde,2017,Total,56653,62404,119057,24002,143059,57586,61424,119010,21991,141001,0.9837981453825583,1.015954675696796,1.0003949247962356,1.0914465008412533,1.0145956411656656
